Event,Device,Trip,Starttime,Endtime,Duration
1,92,43,11440,12300,860
2,501,8,80350,81830,1480
3,501,39,200610,201400,790
4,501,43,13660,14440,780
5,501,56,113430,114200,770
6,501,741,23990,25280,1290
7,501,744,162610,163720,1110
8,501,747,10550,11690,1140
9,501,749,155970,157180,1210
10,501,754,16700,17970,1270
11,501,755,151770,152840,1070
12,501,759,7740,9230,1490
13,501,760,17330,18820,1490
14,501,761,161560,162710,1150
15,501,767,155100,156450,1350
16,501,768,14190,15760,1570
17,501,774,104950,106280,1330
18,501,777,140600,141880,1280
19,502,11,162910,163780,870
20,502,24,108550,109660,1110
21,502,29,116770,117560,790
22,502,46,103390,104180,790
23,502,52,111420,112370,950
24,502,58,106810,108280,1470
25,502,73,90490,91500,1010
26,502,80,105180,106230,1050
27,502,112,90680,92010,1330
28,502,123,94510,95240,730
29,502,130,117770,119120,1350
30,502,137,116460,117330,870
31,502,142,92590,93820,1230
32,502,154,96550,98980,2430
33,502,159,126290,127040,750
34,502,179,96630,97400,770
35,502,184,18240,19130,890
36,502,243,101910,102560,650
37,502,248,85230,85920,690
38,502,261,79380,80230,850
39,502,279,61080,61880,800
40,502,285,98280,99230,950
41,502,293,109890,110660,770
42,502,299,108160,108890,730
43,502,322,169940,170850,910
44,502,328,102440,103170,730
45,502,332,110080,110810,730
46,502,661,43660,47030,3370
47,551,69,90760,92170,1410
48,551,561,24760,25920,1160
49,551,579,21370,22350,980
50,551,585,89920,90890,970
51,552,340,116850,118710,1860
52,552,354,1470,1920,450
53,552,355,200,7300,7100
54,552,356,210,10760,10550
55,552,360,109460,111230,1770
56,552,374,144530,146650,2120
57,552,375,1200,1350,150
58,552,380,154600,156380,1780
59,552,382,166010,167710,1700
60,3268,43,474380,475580,1200
61,3268,79,68980,69970,990
62,10120,285,125970,127340,1370
63,10120,397,19280,20390,1110
64,10120,398,1600,2720,1120
65,10122,5,142050,143430,1380
66,10122,13,136270,137720,1450
67,10122,16,304200,305730,1530
68,10122,16,310740,312330,1590
69,10122,30,142530,143960,1430
70,10122,35,148980,150350,1370
71,10122,38,135510,137020,1510
72,10122,41,137740,139190,1450
73,10122,52,193150,194620,1470
74,10122,54,180950,182370,1420
75,10122,57,142410,143680,1270
76,10122,57,164750,166180,1430
77,10122,58,71770,73100,1330
78,10122,59,2980,4400,1420
79,10122,61,135020,136530,1510
80,10122,66,131880,133530,1650
81,10122,70,147260,148810,1550
82,10122,71,3720,5730,2010
83,10122,74,133990,135310,1320
84,10122,76,307350,308920,1570
85,10122,90,138040,139400,1360
86,10122,102,145270,146820,1550
87,10122,105,142900,144430,1530
88,10122,110,147680,149150,1470
89,10122,116,148980,150450,1470
90,10122,118,162090,163660,1570
91,10122,120,67330,68940,1610
92,10122,155,143140,144510,1370
93,10122,160,146490,148080,1590
94,10122,161,2690,3470,780
95,10122,162,134060,135590,1530
96,10122,169,139130,140720,1590
97,10122,173,144200,145730,1530
98,10122,175,151990,153400,1410
99,10122,180,148720,150170,1450
100,10122,183,163300,164750,1450
101,10122,192,162240,163690,1450
102,10122,194,158160,159790,1630
103,10122,197,150010,151900,1890
104,10122,202,139950,141290,1340
105,10122,202,149500,150960,1460
106,10122,206,197360,198650,1290
107,10122,206,204840,206390,1550
108,10122,207,4880,6310,1430
109,10122,208,130210,131860,1650
110,10122,209,227230,228680,1450
111,10122,213,159560,161390,1830
112,10122,215,153150,154680,1530
113,10122,220,162850,164320,1470
114,10122,224,181420,182790,1370
115,10122,227,171250,173200,1950
116,10122,234,171420,173130,1710
117,10122,236,225390,226920,1530
118,10122,238,203110,204540,1430
119,10122,240,358880,360550,1670
120,10122,242,155780,157190,1410
121,10122,251,159580,160970,1390
122,10122,253,192360,193790,1430
123,10122,255,169400,170750,1350
124,10122,257,166110,167480,1370
125,10122,260,149960,151310,1350
126,10122,272,145090,146500,1410
127,10122,274,148740,150110,1370
128,10122,276,145960,147340,1380
129,10122,278,199760,201690,1930
130,10122,285,132520,134010,1490
131,10122,286,10460,11990,1530
132,10122,287,211790,213400,1610
133,10122,289,34660,36370,1710
134,10122,291,478570,480000,1430
135,10122,291,490130,491550,1420
136,10122,292,53760,55160,1400
137,10122,292,238180,240410,2230
138,10122,295,147580,148910,1330
139,10122,301,137960,139330,1370
140,10122,305,158360,159850,1490
141,10122,308,146200,147590,1390
142,10122,312,139460,140690,1230
143,10122,317,146680,147870,1190
144,10122,318,5350,6650,1300
145,10122,331,88770,90130,1360
146,10122,332,1500,2950,1450
147,10122,334,179990,181860,1870
148,10122,335,3380,4590,1210
149,10122,337,219180,220600,1420
150,10122,340,2370,3860,1490
151,10122,341,141330,142610,1280
152,10122,342,2470,3730,1260
153,10122,347,166440,167770,1330
154,10122,348,980,2260,1280
155,10122,351,151330,152720,1390
156,10122,352,3660,4980,1320
157,10122,354,171610,172960,1350
158,10122,355,320,1710,1390
159,10122,357,134280,135580,1300
160,10122,358,1710,2950,1240
161,10122,368,140560,141880,1320
162,10122,369,5050,6310,1260
163,10122,370,159240,160590,1350
164,10122,371,6840,8230,1390
165,10122,375,152830,154050,1220
166,10122,376,17440,18760,1320
167,10122,381,106700,108050,1350
168,10122,382,10620,11870,1250
169,10122,386,130430,131760,1330
170,10122,387,6930,8240,1310
171,10122,398,146930,148320,1390
172,10122,399,14770,16060,1290
173,10122,403,156450,157840,1390
174,10122,404,7060,8470,1410
175,10122,406,137170,138480,1310
176,10122,407,5430,7040,1610
177,10122,409,133580,134930,1350
178,10122,410,940,2420,1480
179,10122,413,152590,153840,1250
180,10122,414,3200,4700,1500
181,10122,416,5140,6390,1250
182,10122,425,152980,154450,1470
183,10122,426,4490,5870,1380
184,10122,427,152670,154150,1480
185,10122,428,1920,3320,1400
186,10122,430,179880,181230,1350
187,10122,431,3380,4660,1280
188,10122,432,171420,172840,1420
189,10122,433,3780,5120,1340
190,10122,437,22020,23630,1610
191,10122,438,760,760,0
192,10122,438,3620,4830,1210
193,10122,446,193590,194950,1360
194,10122,447,9180,10440,1260
195,10122,448,164440,165910,1470
196,10122,449,5700,7040,1340
197,10122,453,153580,154960,1380
198,10122,454,9160,10520,1360
199,10122,456,81160,82650,1490
200,10122,457,2350,3560,1210
201,10122,459,145390,146760,1370
202,10122,468,7040,8310,1270
203,10122,469,3920,4150,230
204,10122,471,28740,30030,1290
205,10122,472,4150,5420,1270
206,10122,473,162690,164010,1320
207,10122,474,4030,5370,1340
208,10122,475,177860,180170,2310
209,10122,476,6650,7920,1270
210,10122,478,136990,138500,1510
211,10122,479,9050,10240,1190
212,10122,489,163720,165130,1410
213,10122,490,4240,5470,1230
214,10122,492,163560,164860,1300
215,10122,492,171820,173450,1630
216,10122,493,3840,5690,1850
217,10122,495,69470,70770,1300
218,10122,496,5020,6710,1690
219,10122,499,141080,142310,1230
220,10122,500,3140,4390,1250
221,10122,505,136140,137410,1270
222,10122,506,9860,11150,1290
223,10122,508,139540,140820,1280
224,10122,509,5680,7070,1390
225,10122,514,163610,164920,1310
226,10122,515,2850,4260,1410
227,10122,518,150320,151660,1340
228,10122,518,159330,161070,1740
229,10122,519,3350,4910,1560
230,10122,523,155570,157030,1460
231,10122,524,1860,4440,2580
232,10122,530,210360,211680,1320
233,10122,531,5720,7000,1280
234,10122,544,143350,144630,1280
235,10122,545,4450,5930,1480
236,10122,548,160100,161430,1330
237,10122,549,6220,7570,1350
238,10122,550,128070,129330,1260
239,10122,551,4280,5710,1430
240,10122,555,58410,59700,1290
241,10122,555,67870,69480,1610
242,10122,556,4800,6430,1630
243,10122,560,3140,4600,1460
244,10122,565,146350,148290,1940
245,10122,566,8790,10120,1330
246,10122,575,10950,13400,2450
247,10122,576,2570,3930,1360
248,10122,577,149590,150930,1340
249,10122,578,3570,5250,1680
250,10122,579,186750,188110,1360
251,10122,580,1100,2560,1460
252,10122,586,10990,13420,2430
253,10122,589,121670,123070,1400
254,10122,601,167510,168810,1300
255,10122,602,9430,10800,1370
256,10122,603,157630,158940,1310
257,10122,604,7850,9180,1330
258,10122,607,158500,160500,2000
259,10122,608,3630,4890,1260
260,10122,612,161550,162930,1380
261,10122,613,6740,7940,1200
262,10122,622,156350,157740,1390
263,10122,623,2770,4080,1310
264,10122,633,163520,164840,1320
265,10122,634,7800,9180,1380
266,10122,640,145070,146810,1740
267,10122,641,3140,4630,1490
268,10122,643,186170,187480,1310
269,10122,644,2550,3980,1430
270,10122,646,7360,8690,1330
271,10122,648,157460,158800,1340
272,10122,649,3830,5310,1480
273,10122,650,151280,152700,1420
274,10122,651,5410,6860,1450
275,10122,652,155620,157070,1450
276,10122,653,6000,7500,1500
277,10122,655,151740,153710,1970
278,10122,656,3020,3740,720
279,10122,659,161450,163050,1600
280,10122,660,2990,4360,1370
281,10122,662,153730,155260,1530
282,10122,663,2200,2880,680
283,10122,665,142170,143570,1400
284,10122,666,8500,9860,1360
285,10122,669,2650,4120,1470
286,10122,670,141430,142880,1450
287,10122,671,1740,3160,1420
288,10122,673,144300,145800,1500
289,10122,676,1950,3350,1400
290,10122,680,4320,5740,1420
291,10122,683,3500,4830,1330
292,10122,687,3910,5600,1690
293,10122,688,141010,143040,2030
294,10122,694,143020,144290,1270
295,10122,695,1530,2840,1310
296,10122,698,127340,129270,1930
297,10122,699,2600,3970,1370
298,10122,701,13470,14710,1240
299,10122,702,2010,3340,1330
300,10122,704,150070,151370,1300
301,10122,705,5780,7020,1240
302,10122,724,1490,3010,1520
303,10122,737,134280,135440,1160
304,10122,738,6950,8560,1610
305,10122,741,160120,161360,1240
306,10122,744,16470,18810,2340
307,10122,745,3310,5010,1700
308,10122,746,145350,146640,1290
309,10122,747,3440,4750,1310
310,10122,755,143230,144520,1290
311,10122,756,5180,6640,1460
312,10122,757,152730,154070,1340
313,10122,758,3450,4850,1400
314,10122,760,146590,147770,1180
315,10122,761,1500,2960,1460
316,10122,764,147240,148400,1160
317,10122,765,3150,4460,1310
318,10122,766,149750,151050,1300
319,10122,767,1530,3110,1580
320,10122,768,150800,152140,1340
321,10122,769,4140,5700,1560
322,10122,770,127080,128320,1240
323,10122,771,2740,4140,1400
324,10122,775,135960,137160,1200
325,10122,776,4400,5700,1300
326,10122,778,150150,151440,1290
327,10122,779,2910,4290,1380
328,10122,797,158220,159520,1300
329,10122,798,1950,3630,1680
330,10122,801,169670,170970,1300
331,10122,802,9390,10770,1380
332,10122,803,138830,140080,1250
333,10122,804,5230,6550,1320
334,10122,808,152140,153290,1150
335,10122,809,1980,3950,1970
336,10122,810,137540,138840,1300
337,10122,811,3350,4720,1370
338,10122,816,135180,136420,1240
339,10122,817,1970,3300,1330
340,10122,819,249240,250430,1190
341,10122,819,258300,259760,1460
342,10122,820,4850,6660,1810
343,10122,821,157680,158930,1250
344,10122,822,3780,5120,1340
345,10122,827,172560,174300,1740
346,10122,828,2900,4230,1330
347,10122,829,194190,195440,1250
348,10122,830,2140,3430,1290
349,10122,832,151420,152970,1550
350,10122,833,4300,5620,1320
351,10122,845,179480,180840,1360
352,10122,846,6350,7620,1270
353,10122,849,167400,168690,1290
354,10122,850,3240,4580,1340
355,10122,855,140570,141960,1390
356,10122,856,6150,7520,1370
357,10122,859,152570,154060,1490
358,10122,860,3190,4550,1360
359,10122,861,182120,183450,1330
360,10122,862,5300,6740,1440
361,10122,865,160400,161680,1280
362,10122,866,3940,5360,1420
363,10122,871,53060,54620,1560
364,10122,871,61820,63310,1490
365,10122,872,2300,2370,70
366,10122,873,3140,4500,1360
367,10122,877,148060,149350,1290
368,10122,878,9770,11050,1280
369,10122,887,157880,159320,1440
370,10122,888,2900,4300,1400
371,10122,891,171770,173270,1500
372,10122,893,7650,8890,1240
373,10122,894,151090,152370,1280
374,10122,895,4860,6210,1350
375,10122,897,160660,162060,1400
376,10122,898,3570,4970,1400
377,10122,899,139780,141090,1310
378,10122,899,148480,150210,1730
379,10122,900,2530,4340,1810
380,10122,902,3180,4610,1430
381,10122,909,154490,155790,1300
382,10122,909,162850,164170,1320
383,10122,910,3180,4690,1510
384,10122,912,156900,158200,1300
385,10122,913,6010,7270,1260
386,10122,915,163030,164280,1250
387,10122,915,172020,173940,1920
388,10122,916,3810,5760,1950
389,10122,919,149340,150900,1560
390,10122,924,20250,21610,1360
391,10122,925,143890,145330,1440
392,10122,926,11380,12920,1540
393,10122,935,214190,215400,1210
394,10122,936,6600,7820,1220
395,10122,937,174640,176060,1420
396,10122,938,8900,10180,1280
397,10122,945,154680,156400,1720
398,10122,946,5450,6850,1400
399,10122,947,145060,146430,1370
400,10122,948,2270,3820,1550
401,10122,961,155630,156870,1240
402,10122,962,2890,4260,1370
403,10122,965,153220,154650,1430
404,10122,966,3560,5050,1490
405,10122,967,147510,149400,1890
406,10122,968,2710,4010,1300
407,10122,971,114210,115620,1410
408,10122,972,1150,2440,1290
409,10122,976,143170,144450,1280
410,10122,977,5090,6390,1300
411,10122,983,202030,203490,1460
412,10122,984,6110,7760,1650
413,10122,985,156870,158460,1590
414,10122,988,6350,7730,1380
415,10122,989,156090,157500,1410
416,10122,990,2790,4100,1310
417,10122,995,159900,161510,1610
418,10122,996,3610,5900,2290
419,10122,997,129560,130930,1370
420,10122,998,1700,3020,1320
421,10122,1000,2980,4350,1370
422,10122,1004,150220,151660,1440
423,10122,1005,2010,3320,1310
424,10122,1006,148880,150260,1380
425,10122,1007,4660,6020,1360
426,10122,1011,146260,147520,1260
427,10122,1011,155340,156820,1480
428,10122,1012,6170,8380,2210
429,10122,1017,190880,192340,1460
430,10122,1018,6900,8390,1490
431,10122,1020,179150,180530,1380
432,10122,1021,1730,3050,1320
433,10122,1023,146920,148250,1330
434,10122,1024,4300,5560,1260
435,10122,1032,177290,178580,1290
436,10122,1033,3190,4490,1300
437,10122,1034,173220,174470,1250
438,10122,1035,390,1360,970
439,10122,1036,130620,131900,1280
440,10122,1037,3930,5200,1270
441,10122,1040,183280,185080,1800
442,10122,1041,1830,3100,1270
443,10122,1043,157700,158970,1270
444,10122,1044,3680,4980,1300
445,10122,1046,16870,18330,1460
446,10122,1047,2940,4460,1520
447,10122,1048,133170,134290,1120
448,10122,1049,2900,4470,1570
449,10122,1060,147320,148680,1360
450,10122,1061,2210,3400,1190
451,10122,1063,2740,4230,1490
452,10122,1066,4840,6190,1350
453,10122,1067,146870,148220,1350
454,10122,1068,6690,8040,1350
455,10122,1069,148500,149810,1310
456,10122,1070,2720,4060,1340
457,10122,1071,136900,138220,1320
458,10122,1072,4950,6290,1340
459,10122,1073,147110,148380,1270
460,10122,1074,5600,7530,1930
461,10122,1075,149590,151030,1440
462,10122,1076,7360,8890,1530
463,10122,1077,161160,162380,1220
464,10122,1078,2710,3960,1250
465,10122,1085,140400,141770,1370
466,10122,1089,4440,5740,1300
467,10122,1091,146830,148080,1250
468,10122,1092,4380,5920,1540
469,10122,1094,145890,147150,1260
470,10122,1095,4190,5530,1340
471,10122,1096,144440,145780,1340
472,10122,1097,3320,4620,1300
473,10122,1115,162330,163570,1240
474,10122,1116,4710,6630,1920
475,10122,1118,203210,204630,1420
476,10122,1119,4130,5450,1320
477,10122,1120,181990,183400,1410
478,10122,1120,191010,192860,1850
479,10122,1121,2080,3880,1800
480,10122,1123,86350,87940,1590
481,10122,1124,5840,7430,1590
482,10122,1126,53660,55140,1480
483,10122,1127,8480,10140,1660
484,10122,1129,143150,144530,1380
485,10122,1130,3100,4640,1540
486,10122,1136,151620,152820,1200
487,10122,1136,159910,161380,1470
488,10122,1138,184410,185710,1300
489,10122,1139,900,2270,1370
490,10122,1142,175110,176420,1310
491,10122,1143,6940,8140,1200
492,10122,1224,144130,145440,1310
493,10122,1225,2780,4180,1400
494,10122,1228,150360,151710,1350
495,10122,1229,880,2210,1330
496,10122,1234,165770,167320,1550
497,10122,1239,128810,130150,1340
498,10122,1240,2390,3630,1240
499,10122,1263,132050,133380,1330
500,10122,1287,122030,123700,1670
501,10122,1288,2030,2100,70
502,10122,1295,194510,196010,1500
503,10122,1298,2680,4340,1660
504,10122,1299,227650,230310,2660
505,10122,1300,2920,8730,5810
506,10122,1301,271910,274080,2170
507,10122,1302,11050,13290,2240
508,10122,1304,248540,249960,1420
509,10122,1305,2610,4150,1540
510,10122,1312,144660,146000,1340
511,10122,1312,153290,154840,1550
512,10122,1313,4460,6110,1650
513,10122,1315,178090,179400,1310
514,10122,1316,6290,7700,1410
515,10122,1318,166990,168740,1750
516,10122,1319,4510,5830,1320
517,10122,1322,166240,167480,1240
518,10122,1323,15170,16610,1440
519,10122,1325,252750,254220,1470
520,10122,1326,7680,9070,1390
521,10122,1329,166950,168200,1250
522,10122,1330,1770,3120,1350
523,10122,1337,150430,151810,1380
524,10122,1338,10970,12400,1430
525,10122,1339,204930,206280,1350
526,10122,1340,2090,3400,1310
527,10122,1341,144210,145450,1240
528,10122,1342,19110,20570,1460
529,10122,1343,428160,429720,1560
530,10122,1344,5340,6650,1310
531,10122,1345,142440,143650,1210
532,10122,1346,4890,6330,1440
533,10122,1354,418440,420160,1720
534,10122,1355,12180,13640,1460
535,10122,1356,168800,170140,1340
536,10122,1357,4810,6640,1830
537,10122,1359,199300,200890,1590
538,10122,1359,209340,210820,1480
539,10122,1360,4090,6820,2730
540,10122,1361,170070,171370,1300
541,10122,1362,5340,6830,1490
542,10122,1365,46430,47610,1180
543,10122,1366,2310,4120,1810
544,10122,1373,143500,145350,1850
545,10122,1374,6700,8500,1800
546,10122,1379,518140,522040,3900
547,10122,1380,4470,6140,1670
548,10122,1381,464540,466170,1630
549,10122,1382,2130,3710,1580
550,10122,1384,155810,157130,1320
551,10122,1385,7250,8810,1560
552,10122,1395,158850,160180,1330
553,10122,1396,3410,4940,1530
554,10122,1397,45810,47470,1660
555,10122,1398,3950,5700,1750
556,10122,1402,156330,157580,1250
557,10122,1403,7150,8650,1500
558,10122,1408,151100,152290,1190
559,10122,1409,6820,8080,1260
560,10122,1410,162130,163450,1320
561,10122,1411,2410,3840,1430
562,10122,1412,152110,153510,1400
563,10122,1413,11750,13080,1330
564,10122,1427,146880,148110,1230
565,10122,1428,2960,4880,1920
566,10122,1430,194430,196040,1610
567,10122,1431,13740,15120,1380
568,10122,1433,141790,143510,1720
569,10122,1434,2970,4370,1400
570,10122,1437,172620,174010,1390
571,10122,1438,5210,6710,1500
572,10122,1439,157190,158580,1390
573,10122,1440,850,2230,1380
574,10122,1460,179980,181380,1400
575,10122,1461,3240,4600,1360
576,10122,1463,181680,183240,1560
577,10122,1464,3430,5020,1590
578,10125,715,2570,2580,10
579,10125,715,4140,4150,10
580,10129,414,25680,27060,1380
581,10129,963,3060,4020,960
582,10133,97,6730,7590,860
583,10137,3067,3820,5860,2040
584,10138,1869,32510,34250,1740
585,10138,3112,4480,5830,1350
586,10139,782,70340,71490,1150
587,10139,832,81000,82490,1490
588,10139,5014,59770,61100,1330
589,10139,5018,90780,92110,1330
590,10139,5020,64870,66020,1150
591,10139,7138,88920,90470,1550
592,10146,629,4190,6580,2390
593,10146,629,8300,9730,1430
594,10150,403,31290,32390,1100
595,10150,430,39610,40610,1000
596,10150,769,198180,199450,1270
597,10150,769,215690,217750,2060
598,10150,781,190520,191690,1170
599,10150,781,202910,204000,1090
600,10150,1953,270,300,30
601,10150,2300,20780,21980,1200
602,10150,2426,2950,2950,0
603,10150,3087,115550,116610,1060
604,10150,3145,5610,6700,1090
605,10150,4039,14780,15880,1100
606,10150,4067,50750,51900,1150
607,10150,4158,240,290,50
608,10150,5473,26920,40470,13550
609,10150,5486,20160,20500,340
610,10150,5486,22630,23860,1230
611,10150,5486,27860,29980,2120
612,10150,5502,37840,39660,1820
613,10150,5509,21190,22610,1420
614,10150,5564,41040,49460,8420
615,10150,5572,25250,27230,1980
616,10150,5579,17640,17980,340
617,10150,5579,20860,21420,560
618,10150,5580,190,770,580
619,10150,5584,17180,18750,1570
620,10150,5588,31780,33120,1340
621,10150,5592,20860,22690,1830
622,10150,5607,38570,40510,1940
623,10150,5630,35130,36980,1850
624,10150,5646,16990,18620,1630
625,10150,5651,18440,20270,1830
626,10150,5655,26550,28480,1930
627,10150,5663,23600,25520,1920
628,10150,5677,19780,21870,2090
629,10150,5690,18170,19940,1770
630,10150,5699,30540,34230,3690
631,10150,5703,23700,24300,600
632,10150,5773,25990,27660,1670
633,10150,5798,20040,21670,1630
634,10150,5802,8920,10910,1990
635,10155,558,25770,26560,790
636,10155,633,67840,69070,1230
637,10155,659,54490,55560,1070
638,10155,1051,43890,45020,1130
639,10155,1148,10090,11410,1320
640,10160,711,4130,5320,1190
641,10160,716,161550,162970,1420
642,10161,865,18700,20080,1380
643,10161,989,39040,40400,1360
644,10161,2166,74650,75920,1270
645,10161,2167,8150,9680,1530
646,10161,2168,52660,53830,1170
647,10162,110,4630,5200,570
648,10164,931,52260,53350,1090
649,10164,1162,52490,53790,1300
650,10164,1225,53260,54370,1110
651,10164,2147,65530,66770,1240
652,10165,15,5090,6530,1440
653,10165,16,4040,5650,1610
654,10165,20,62030,63490,1460
655,10165,21,6770,8400,1630
656,10165,29,72120,73710,1590
657,10165,30,3740,5430,1690
658,10165,33,65480,67120,1640
659,10165,34,30800,32810,2010
660,10165,39,11070,13090,2020
661,10165,40,3540,5290,1750
662,10165,44,15340,16810,1470
663,10165,45,8780,10410,1630
664,10165,50,70640,72260,1620
665,10165,55,5370,6810,1440
666,10165,56,3200,3460,260
667,10165,76,5480,7210,1730
668,10165,77,8370,9820,1450
669,10165,80,54080,56080,2000
670,10165,81,7900,9460,1560
671,10165,84,70280,71860,1580
672,10165,85,4560,6590,2030
673,10165,89,62120,63790,1670
674,10165,90,3050,4210,1160
675,10165,98,6920,8690,1770
676,10165,99,2890,4400,1510
677,10165,127,70250,71930,1680
678,10165,128,4290,5830,1540
679,10165,130,67130,68600,1470
680,10165,131,4730,7020,2290
681,10165,135,7310,8930,1620
682,10165,140,60290,62100,1810
683,10165,141,3660,4530,870
684,10165,163,56870,58520,1650
685,10165,164,8150,9840,1690
686,10165,167,68970,70540,1570
687,10165,168,4090,6170,2080
688,10165,174,60070,61590,1520
689,10165,184,72310,74390,2080
690,10165,185,2470,3860,1390
691,10165,188,70020,71620,1600
692,10165,189,8230,9780,1550
693,10165,197,67460,69190,1730
694,10165,198,3390,5100,1710
695,10165,202,77900,80190,2290
696,10165,203,2360,3880,1520
697,10165,210,57910,59460,1550
698,10165,211,3270,3720,450
699,10165,214,56010,57440,1430
700,10165,215,11930,13990,2060
701,10165,220,53290,54880,1590
702,10165,221,5800,8070,2270
703,10165,236,55660,57160,1500
704,10165,237,3650,5100,1450
705,10165,241,54560,56000,1440
706,10165,246,74200,75630,1430
707,10165,247,9710,11270,1560
708,10165,253,64620,66230,1610
709,10165,254,6030,7680,1650
710,10165,285,105920,107410,1490
711,10165,286,4750,6490,1740
712,10165,293,65050,66760,1710
713,10165,297,83710,85380,1670
714,10165,298,5220,6580,1360
715,10165,302,73890,75570,1680
716,10165,303,5380,6830,1450
717,10165,308,74650,76250,1600
718,10165,309,2940,3820,880
719,10165,330,103880,105410,1530
720,10165,331,5460,7040,1580
721,10165,334,89450,90930,1480
722,10165,335,3020,4570,1550
723,10165,350,85900,87460,1560
724,10165,351,9380,11170,1790
725,10165,355,61700,63150,1450
726,10165,356,4170,4710,540
727,10165,359,75800,77470,1670
728,10165,360,4440,5980,1540
729,10165,365,72070,73660,1590
730,10165,369,78810,80760,1950
731,10165,370,2660,4170,1510
732,10165,370,6050,6240,190
733,10165,374,65820,67450,1630
734,10165,375,5980,7500,1520
735,10165,378,68370,70020,1650
736,10165,379,8270,9680,1410
737,10165,398,14990,16820,1830
738,10165,399,9890,11330,1440
739,10165,402,85290,86850,1560
740,10165,403,4760,6250,1490
741,10165,408,54460,55990,1530
742,10165,409,6540,8020,1480
743,10165,416,68490,70070,1580
744,10165,417,6730,8140,1410
745,10165,424,73480,75090,1610
746,10165,425,4670,6240,1570
747,10165,434,66150,67760,1610
748,10165,435,7060,8530,1470
749,10165,437,74320,75960,1640
750,10165,438,3450,4940,1490
751,10165,441,64160,65650,1490
752,10165,442,4300,5980,1680
753,10165,447,63660,65240,1580
754,10165,448,5750,8280,2530
755,10165,452,59610,61080,1470
756,10165,453,3530,5050,1520
757,10165,471,72330,73920,1590
758,10165,472,3620,5030,1410
759,10165,477,92710,94230,1520
760,10165,478,5510,7160,1650
761,10165,481,61910,63670,1760
762,10165,482,3310,5120,1810
763,10165,483,71060,72520,1460
764,10165,484,7960,9830,1870
765,10165,489,72810,74320,1510
766,10165,490,4720,6350,1630
767,10165,492,51940,53590,1650
768,10165,493,2950,3640,690
769,10165,529,213270,215050,1780
770,10165,534,98760,100260,1500
771,10165,535,3220,4980,1760
772,10165,538,72780,74360,1580
773,10165,539,7850,9480,1630
774,10165,542,68290,70140,1850
775,10165,543,4780,6260,1480
776,10165,555,61560,63060,1500
777,10165,561,68380,69810,1430
778,10165,562,2720,4230,1510
779,10165,567,11560,12890,1330
780,10165,568,3670,5540,1870
781,10165,574,74060,75930,1870
782,10165,575,6370,7800,1430
783,10165,578,72400,74010,1610
784,10165,579,5670,7430,1760
785,10165,595,73330,74980,1650
786,10165,596,4060,5470,1410
787,10165,599,61770,63280,1510
788,10165,610,12650,14680,2030
789,10165,614,73590,75230,1640
790,10165,615,5410,7080,1670
791,10165,620,3890,5290,1400
792,10165,634,58030,59550,1520
793,10165,635,3490,4980,1490
794,10165,639,73180,74840,1660
795,10165,640,10890,12730,1840
796,10165,648,76060,77390,1330
797,10165,649,8240,9790,1550
798,10165,652,100410,101750,1340
799,10165,653,12460,14060,1600
800,10165,683,77630,79210,1580
801,10165,684,5760,7260,1500
802,10165,689,78290,79990,1700
803,10165,690,4770,6270,1500
804,10165,693,89020,90430,1410
805,10165,694,6740,8430,1690
806,10165,695,76810,78370,1560
807,10165,696,8970,10350,1380
808,10165,701,96770,98160,1390
809,10165,702,5300,6890,1590
810,10165,790,82960,84380,1420
811,10165,794,134320,136040,1720
812,10165,800,91840,93360,1520
813,10165,810,3480,5060,1580
814,10165,811,4990,5170,180
815,10165,813,15850,17310,1460
816,10165,820,111860,113320,1460
817,10165,821,13920,15450,1530
818,10165,847,63450,64890,1440
819,10165,848,6670,7970,1300
820,10165,857,116510,118040,1530
821,10165,858,5180,6720,1540
822,10165,863,117130,118480,1350
823,10165,864,8330,9700,1370
824,10165,874,100760,102390,1630
825,10165,883,5260,6640,1380
826,10165,908,75850,77480,1630
827,10165,908,85620,86790,1170
828,10165,914,133580,134650,1070
829,10165,914,155880,156950,1070
830,10165,930,66680,67850,1170
831,10165,930,111520,112670,1150
832,10165,954,118980,120640,1660
833,10165,956,2750,2910,160
834,10165,966,125250,126470,1220
835,10165,970,69700,71370,1670
836,10165,971,51340,52790,1450
837,10165,975,78240,80070,1830
838,10165,976,3780,5400,1620
839,10165,982,88320,89710,1390
840,10165,983,104740,105900,1160
841,10165,983,167530,168730,1200
842,10165,983,199890,201020,1130
843,10165,985,89930,91050,1120
844,10165,985,101000,102160,1160
845,10165,1005,111770,113230,1460
846,10165,1006,3210,5060,1850
847,10165,1017,55600,57070,1470
848,10165,1036,123460,125030,1570
849,10165,1037,6140,7590,1450
850,10165,1047,94980,96110,1130
851,10165,1047,112390,113570,1180
852,10165,1072,120750,122110,1360
853,10165,1080,115410,117070,1660
854,10165,1081,6440,8240,1800
855,10165,1091,53060,54530,1470
856,10165,1092,12860,14490,1630
857,10165,1099,68860,70460,1600
858,10165,1145,89200,90480,1280
859,10165,1145,99220,100250,1030
860,10165,1150,101210,103500,2290
861,10165,1151,4010,5330,1320
862,10165,1151,6350,9390,3040
863,10165,1185,121630,125150,3520
864,10165,1186,126810,128810,2000
865,10165,1187,180,2320,2140
866,10165,1187,6590,8240,1650
867,10165,1192,110590,113060,2470
868,10165,1192,146300,149140,2840
869,10165,1192,150970,157400,6430
870,10165,1192,160030,165420,5390
871,10165,1192,169530,175100,5570
872,10165,1192,176920,179390,2470
873,10165,1206,83280,84970,1690
874,10165,1239,110880,112010,1130
875,10165,1239,135320,136530,1210
876,10165,1249,95420,98060,2640
877,10165,1291,117400,118980,1580
878,10165,1292,200,6410,6210
879,10165,1292,8040,9760,1720
880,10165,1302,120460,122250,1790
881,10165,1303,3280,4670,1390
882,10165,1314,120510,122260,1750
883,10165,1315,4340,6210,1870
884,10165,1351,117540,118740,1200
885,10165,1382,89520,109060,19540
886,10165,1382,117740,119370,1630
887,10165,1388,121790,125740,3950
888,10165,1410,122900,125990,3090
889,10165,1411,2890,4220,1330
890,10165,1420,109250,111390,2140
891,10165,1421,3310,4140,830
892,10165,1427,157870,159080,1210
893,10165,1427,172440,173670,1230
894,10165,1430,300,1440,1140
895,10165,1432,163090,164970,1880
896,10165,1433,4460,5920,1460
897,10165,1437,145920,150770,4850
898,10165,1437,161190,162750,1560
899,10165,1445,306160,308180,2020
900,10165,1445,319460,321270,1810
901,10165,1449,120520,121560,1040
902,10165,1449,138210,139110,900
903,10165,1451,184450,187210,2760
904,10165,1451,194030,195460,1430
905,10165,1456,116930,118810,1880
906,10165,1468,186780,188590,1810
907,10165,1468,197770,199120,1350
908,10165,1472,86330,87890,1560
909,10165,1472,118630,120040,1410
910,10165,1473,169840,171080,1240
911,10165,1477,83110,85110,2000
912,10165,1477,106630,108290,1660
913,10165,1479,123560,125140,1580
914,10165,1479,133390,134590,1200
915,10165,1484,93950,95380,1430
916,10165,1484,121910,123510,1600
917,10165,1485,389660,398860,9200
918,10165,1485,401360,403160,1800
919,10165,1490,107950,109610,1660
920,10165,1490,125280,126870,1590
921,10165,1491,162710,164780,2070
922,10165,1491,172970,173990,1020
923,10165,1494,109770,111640,1870
924,10165,1494,180540,182020,1480
925,10165,1520,163310,172410,9100
926,10165,1520,174250,175500,1250
927,10165,1524,94800,96710,1910
928,10165,1525,119850,121370,1520
929,10165,1526,140880,142580,1700
930,10165,1526,155200,156720,1520
931,10165,1529,121080,122900,1820
932,10165,1529,145680,145770,90
933,10165,1529,148720,150340,1620
934,10165,1532,161440,163210,1770
935,10165,1532,165730,171330,5600
936,10165,1532,173060,174400,1340
937,10165,1536,89260,90730,1470
938,10165,1536,101710,103130,1420
939,10165,1537,134130,137610,3480
940,10165,1537,146950,148550,1600
941,10165,1540,281280,282350,1070
942,10165,1540,299650,300740,1090
943,10165,1544,222590,231530,8940
944,10165,1544,234230,236060,1830
945,10165,1547,299900,300870,970
946,10165,1548,200260,201910,1650
947,10165,1558,120720,121980,1260
948,10165,1563,127590,129940,2350
949,10165,1564,131970,133140,1170
950,10165,1568,115490,122670,7180
951,10165,1568,124760,128270,3510
952,10165,1568,133520,143710,10190
953,10165,1568,148260,152690,4430
954,10165,1568,168420,169960,1540
955,10165,1570,131890,142290,10400
956,10165,1570,144140,145630,1490
957,10165,1575,96200,98590,2390
958,10165,1579,238920,240730,1810
959,10165,1579,252230,253590,1360
960,10165,1588,74930,76940,2010
961,10165,1590,468250,470160,1910
962,10165,1595,180500,182890,2390
963,10165,1596,3100,3170,70
964,10165,1619,251610,253590,1980
965,10165,1621,12620,14720,2100
966,10165,1626,162270,167160,4890
967,10165,1626,173040,174560,1520
968,10165,1631,128900,130910,2010
969,10165,1631,132920,151160,18240
970,10165,1632,200,2360,2160
971,10165,1632,6500,9800,3300
972,10165,1632,13990,21190,7200
973,10165,1632,24320,25960,1640
974,10165,1633,170050,182730,12680
975,10165,1633,185340,187560,2220
976,10165,1637,115170,116750,1580
977,10165,1637,128200,130130,1930
978,10165,1639,149050,151010,1960
979,10165,1639,164380,165700,1320
980,10165,1643,290940,306720,15780
981,10165,1643,325770,327700,1930
982,10165,1648,100290,102040,1750
983,10176,2175,12220,12840,620
984,10176,3665,42430,44870,2440
985,10176,3999,20680,20690,10
986,10204,335,62630,63790,1160
987,10204,469,52570,53480,910
988,10204,1525,274520,275780,1260
989,10204,1530,51940,53600,1660
990,10204,1615,37060,38730,1670
991,10204,1615,44230,45780,1550
992,10204,3079,26240,27530,1290
993,10204,3079,36780,38130,1350
994,10204,3079,51900,53170,1270
995,10204,3079,62520,63770,1250
996,10204,3079,73960,75230,1270
997,10204,3079,88760,90250,1490
998,10204,3079,140220,141650,1430
999,10204,3086,6460,7260,800
1000,10204,3168,79160,80410,1250
1001,10204,3169,39290,40720,1430
1002,10204,3174,144960,146350,1390
1003,10204,3174,217660,219070,1410
1004,10204,3174,277740,279110,1370
1005,10204,3176,12730,14020,1290
1006,10204,3179,83810,85080,1270
1007,10204,3179,154990,156420,1430
1008,10204,3179,214950,216320,1370
1009,10204,3179,268430,269760,1330
1010,10204,3181,24570,25860,1290
1011,10204,3181,79310,80740,1430
1012,10204,3182,78570,79920,1350
1013,10204,3182,149530,150980,1450
1014,10204,3182,208150,209440,1290
1015,10204,3184,39670,40780,1110
1016,10204,3184,94990,96200,1210
1017,10204,3187,74180,75710,1530
1018,10204,3187,133020,134530,1510
1019,10204,3187,190640,192170,1530
1020,10204,3189,121050,122280,1230
1021,10204,3189,180970,182200,1230
1022,10204,3190,23950,25400,1450
1023,10204,3190,85310,86720,1410
1024,10204,3190,146570,148020,1450
1025,10204,3190,198970,200420,1450
1026,10204,3192,28590,29260,670
1027,10204,3194,39910,41360,1450
1028,10204,3200,19890,21240,1350
1029,10204,3201,4810,6120,1310
1030,10204,3202,18700,20230,1530
1031,10204,3202,85910,87380,1470
1032,10204,3202,143710,145040,1330
1033,10204,3203,11860,13150,1290
1034,10204,3205,25420,26690,1270
1035,10204,3205,77840,79210,1370
1036,10204,3206,65300,66430,1130
1037,10204,3206,126180,127310,1130
1038,10204,3206,204800,206050,1250
1039,10204,3209,36370,37820,1450
1040,10204,3209,91670,93020,1350
1041,10204,3233,50700,52030,1330
1042,10204,3233,122680,124070,1390
1043,10204,3233,184180,185670,1490
1044,10204,3233,261060,262370,1310
1045,10204,3234,23320,24550,1230
1046,10204,3234,72020,73210,1190
1047,10204,3235,18000,19310,1310
1048,10204,3235,87020,88310,1290
1049,10204,3235,146280,147650,1370
1050,10204,3235,223740,225050,1310
1051,10204,3236,33440,34590,1150
1052,10204,3237,53800,55190,1390
1053,10204,3238,71020,72590,1570
1054,10205,250,1540,1610,70
1055,10205,254,60250,61230,980
1056,10205,475,2540,2540,0
1057,10205,811,200,490,290
1058,10205,1266,56060,57120,1060
1059,10205,1321,61370,62340,970
1060,10205,1423,66390,67660,1270
1061,10205,1433,90770,92070,1300
1062,10205,1540,55730,56980,1250
1063,10205,1647,94030,95080,1050
1064,10205,1653,174730,176120,1390
1065,10205,1654,78530,79910,1380
1066,10205,1790,310210,311280,1070
1067,10207,1281,97340,98210,870
1068,10502,1339,66220,67380,1160
1069,10502,1465,64880,66060,1180
1070,10502,1557,65120,66420,1300
1071,10502,1675,10200,11150,950
1072,10502,1787,58750,60220,1470
1073,10502,1901,8730,10730,2000
1074,10502,2850,710,760,50
1075,10502,2900,420,470,50
1076,10502,3106,24060,26410,2350
1077,10510,471,48340,49680,1340
1078,10510,1607,1390,2170,780
1079,10510,2934,37940,39150,1210
1080,10557,388,870,2080,1210
1081,10568,462,35590,36640,1050
1082,10569,1821,44550,45780,1230
1083,10570,5833,42590,44640,2050
1084,10570,5833,50720,51900,1180
1085,10570,6021,40830,42500,1670
1086,10570,6021,54840,56480,1640
1087,10570,6078,2090,2680,590
1088,10570,6078,4910,5360,450
1089,10570,6078,18020,19910,1890
1090,10571,3116,104920,105780,860
1091,10571,3119,93690,94700,1010
1092,10571,3123,910,2120,1210
1093,10571,3124,150620,151590,970
1094,10571,3131,195390,197180,1790
1095,10571,3134,131570,132650,1080
1096,10572,28,4230,5350,1120
1097,10572,44,1990,3830,1840
1098,10572,50,850,950,100
1099,10572,53,4190,5620,1430
1100,10572,61,104320,105610,1290
1101,10572,67,4040,4850,810
1102,10572,102,44480,46160,1680
1103,10572,103,2880,4320,1440
1104,10572,107,109340,110560,1220
1105,10572,108,2920,4350,1430
1106,10572,109,83870,85200,1330
1107,10572,112,2170,3410,1240
1108,10572,137,104020,105180,1160
1109,10572,143,28430,30010,1580
1110,10572,144,2900,4640,1740
1111,10572,146,91200,92850,1650
1112,10572,147,2710,2720,10
1113,10572,177,4350,5750,1400
1114,10572,180,95740,97680,1940
1115,10572,183,130840,132220,1380
1116,10572,206,90410,91680,1270
1117,10572,220,78990,80030,1040
1118,10572,221,1620,2770,1150
1119,10573,456,116380,118370,1990
1120,10573,616,64290,65710,1420
1121,10574,1564,13030,14400,1370
1122,10574,1564,19060,21810,2750
1123,10574,1565,2980,4280,1300
1124,10574,2982,98710,99950,1240
1125,10574,2989,136100,137740,1640
1126,10574,3446,22970,24690,1720
1127,10575,1225,8730,8770,40
1128,10575,1226,1730,2360,630
1129,10584,29,76430,77870,1440
1130,10584,29,87560,88600,1040
1131,10584,64,24120,25400,1280
1132,10584,78,7120,8280,1160
1133,10584,86,22790,23870,1080
1134,10584,201,1860,2780,920
1135,10584,203,17550,18520,970
1136,10584,238,81230,82560,1330
1137,10584,271,28570,29690,1120
1138,10584,285,26850,28190,1340
1139,10584,287,51300,52730,1430
1140,10584,405,18380,19510,1130
1141,10584,484,35960,37230,1270
1142,10584,559,63190,64280,1090
1143,10584,588,67360,68500,1140
1144,10584,797,10220,11310,1090
1145,10584,801,13750,15120,1370
1146,10584,826,30780,31860,1080
1147,10584,871,29760,31030,1270
1148,10584,916,25910,27080,1170
1149,10584,1006,17900,19210,1310
1150,10584,1097,6200,7300,1100
1151,10584,1100,18160,19200,1040
1152,10584,1116,20850,21880,1030
1153,10584,1170,51560,52750,1190
1154,10585,1643,56320,59530,3210
1155,10587,221,33540,35080,1540
1156,10587,323,13880,15580,1700
1157,10587,894,27330,28470,1140
1158,10587,1501,21910,23040,1130
1159,10587,1538,51970,52990,1020
1160,10587,1560,42980,44400,1420
1161,10587,1589,47170,48410,1240
1162,10587,1620,108290,109310,1020
1163,10587,1634,34470,35570,1100
1164,10587,1695,44110,45170,1060
1165,10587,1812,640,940,300
1166,10587,1871,46960,48410,1450
1167,10587,1873,31100,32850,1750
1168,10587,1988,64770,65890,1120
1169,10587,2050,56950,58190,1240
1170,10587,2052,23820,24840,1020
1171,10587,2089,27370,28460,1090
1172,10587,2090,25690,27080,1390
1173,10587,2221,141690,143210,1520
1174,10587,2222,20880,22320,1440
1175,10587,2222,28700,29750,1050
1176,10587,2317,3600,4800,1200
1177,10587,2533,28480,30480,2000
1178,10587,2565,10140,11070,930
1179,10587,3204,65320,66710,1390
1180,10587,3469,1440,1660,220
1181,10587,3988,69280,70370,1090
1182,10587,4053,15580,17610,2030
1183,10587,4053,31500,31750,250
1184,10587,4053,33520,35510,1990
1185,10587,4056,5780,5830,50
1186,10587,4090,95160,96860,1700
1187,10587,4090,114950,117020,2070
1188,10587,4146,3360,4590,1230
1189,10587,4931,750,1780,1030
1190,10587,5624,2130,3260,1130
1191,10593,815,19310,20730,1420
1192,10594,10025,320,800,480
1193,10594,10088,14460,16610,2150
1194,10595,2890,146280,147840,1560
1195,10595,4809,152910,154290,1380
1196,10597,1331,73840,75480,1640
1197,10597,1332,4600,5940,1340
1198,10604,861,800,1370,570
1199,10605,5561,242110,243770,1660
1200,10605,5957,106910,108340,1430
1201,10605,8924,2710,2830,120
1202,10605,10316,82490,83610,1120
1203,10607,353,120970,121870,900
1204,10607,356,145300,146640,1340
1205,10607,786,143590,144690,1100
1206,10607,939,276550,278300,1750
1207,10607,939,298980,300550,1570
1208,10607,1612,19230,20480,1250
1209,10607,4610,277320,278490,1170
1210,10607,4640,204940,206050,1110
1211,10607,4641,105790,106760,970
1212,10607,4641,117630,119040,1410
1213,10607,4685,281070,282680,1610
1214,10607,4687,9550,11180,1630
1215,10607,5504,256420,258010,1590
1216,10607,5508,144180,145570,1390
1217,10607,5526,221150,222570,1420
1218,10607,5708,8730,10340,1610
1219,10607,5709,16460,18090,1630
1220,10607,5818,111180,112420,1240
1221,10607,5895,54780,56450,1670
1222,10607,5915,277530,279030,1500
1223,10607,5916,138380,139650,1270
1224,10607,5924,183520,185000,1480
1225,10607,5927,116520,117890,1370
1226,10607,5933,185890,187180,1290
1227,10607,5936,117200,118590,1390
1228,10607,5938,295330,296760,1430
1229,10607,5942,119260,120560,1300
1230,10611,4215,83950,85320,1370
1231,10612,5545,2820,2820,0
1232,10612,5658,2100,2100,0
1233,10612,5828,810,940,130
1234,10612,5834,640,850,210
1235,10612,5836,700,720,20
1236,10612,5919,410,420,10
1237,10616,977,29830,31770,1940
1238,10616,978,23840,25290,1450
1239,10616,1833,198790,200090,1300
1240,10616,1833,205430,206720,1290
1241,10616,2069,30820,32310,1490
1242,10618,17,73650,75420,1770
1243,10618,18,6200,7930,1730
1244,10618,55,111660,113660,2000
1245,10618,56,9120,11400,2280
1246,10618,56,104310,107620,3310
1247,10618,57,10480,12390,1910
1248,10618,64,105460,106830,1370
1249,10618,65,5140,6930,1790
1250,10618,69,56820,59140,2320
1251,10618,70,10370,12510,2140
1252,10618,77,65840,67590,1750
1253,10618,78,11350,14170,2820
1254,10618,79,67250,68620,1370
1255,10618,79,76870,81320,4450
1256,10618,80,106580,109560,2980
1257,10618,80,122080,123950,1870
1258,10618,81,5670,7660,1990
1259,10618,82,10650,12740,2090
1260,10618,83,8700,10970,2270
1261,10618,112,99100,101230,2130
1262,10618,113,8730,10900,2170
1263,10618,113,153270,155130,1860
1264,10618,114,8480,10830,2350
1265,10618,122,146160,148700,2540
1266,10618,123,24450,27160,2710
1267,10618,125,69780,72380,2600
1268,10618,126,7940,10610,2670
1269,10618,133,149760,151480,1720
1270,10618,134,3670,5400,1730
1271,10618,138,166180,168280,2100
1272,10618,139,7670,9620,1950
1273,10618,145,307390,309770,2380
1274,10618,146,16830,18770,1940
1275,10618,158,122680,124640,1960
1276,10618,159,4190,6470,2280
1277,10618,160,81160,83080,1920
1278,10618,161,7890,10240,2350
1279,10618,168,125650,127090,1440
1280,10618,169,2720,4250,1530
1281,10618,177,106230,107710,1480
1282,10618,178,12180,14300,2120
1283,10618,185,147750,149270,1520
1284,10618,186,10000,11980,1980
1285,10618,187,9960,12190,2230
1286,10618,212,8060,10040,1980
1287,10618,213,5800,7610,1810
1288,10618,217,97850,99900,2050
1289,10618,218,26250,29600,3350
1290,10618,218,215020,216780,1760
1291,10618,219,8900,11420,2520
1292,10618,222,69390,72750,3360
1293,10618,222,114540,116770,2230
1294,10618,224,16230,20950,4720
1295,10618,226,155620,157720,2100
1296,10618,227,6690,8560,1870
1297,10618,229,114520,116480,1960
1298,10618,230,7820,10860,3040
1299,10618,234,96740,98150,1410
1300,10618,234,121880,124760,2880
1301,10618,235,8500,11310,2810
1302,10618,237,205720,207320,1600
1303,10618,237,224720,226350,1630
1304,10618,238,6000,8580,2580
1305,10618,250,67220,68770,1550
1306,10618,251,3880,5800,1920
1307,10618,252,91990,94650,2660
1308,10618,253,12730,14840,2110
1309,10618,273,233040,234870,1830
1310,10618,273,251970,263530,11560
1311,10618,274,210450,212430,1980
1312,10618,275,5870,12910,7040
1313,10618,276,20230,22620,2390
1314,10618,277,4400,6110,1710
1315,10618,282,219030,221360,2330
1316,10618,283,3490,6130,2640
1317,10618,289,138400,140300,1900
1318,10618,290,4550,6440,1890
1319,10618,290,57610,59400,1790
1320,10618,291,3400,5420,2020
1321,10618,301,147040,148750,1710
1322,10618,302,3080,5140,2060
1323,10618,307,69040,70790,1750
1324,10618,308,4860,6430,1570
1325,10618,309,130310,132240,1930
1326,10618,310,6360,8450,2090
1327,10618,311,21590,23320,1730
1328,10618,312,5510,7490,1980
1329,10618,314,59420,61170,1750
1330,10618,315,6420,8280,1860
1331,10618,315,51890,53370,1480
1332,10618,316,3620,11530,7910
1333,10618,324,153680,155060,1380
1334,10618,325,4470,6190,1720
1335,10618,336,75330,77220,1890
1336,10618,337,6750,8860,2110
1337,10618,337,123950,125450,1500
1338,10618,338,4090,5850,1760
1339,10618,349,87980,89570,1590
1340,10618,350,7920,9490,1570
1341,10618,352,78210,80430,2220
1342,10618,353,8020,9350,1330
1343,10618,356,82270,87940,5670
1344,10618,357,4740,6020,1280
1345,10618,359,80200,81810,1610
1346,10618,359,97800,100570,2770
1347,10618,360,5380,7410,2030
1348,10618,363,80420,82090,1670
1349,10618,364,4040,5700,1660
1350,10618,372,78270,79960,1690
1351,10618,373,2460,4490,2030
1352,10618,377,10760,12830,2070
1353,10618,378,12460,14790,2330
1354,10618,378,54230,56260,2030
1355,10618,378,102140,103630,1490
1356,10618,379,3010,4510,1500
1357,10618,384,196390,198250,1860
1358,10618,385,4850,6360,1510
1359,10618,387,107390,109320,1930
1360,10618,388,2160,3670,1510
1361,10618,388,103680,105350,1670
1362,10618,389,3270,5330,2060
1363,10618,391,83670,85320,1650
1364,10618,392,9190,10630,1440
1365,10618,392,59450,60830,1380
1366,10618,393,6010,7290,1280
1367,10618,394,122170,123940,1770
1368,10618,395,3770,5460,1690
1369,10618,401,165350,167640,2290
1370,10618,402,9820,15410,5590
1371,10618,402,53050,54370,1320
1372,10618,402,88180,89660,1480
1373,10618,403,7020,8660,1640
1374,10618,423,76950,78620,1670
1375,10618,424,6940,8770,1830
1376,10618,425,81110,82370,1260
1377,10618,426,4110,8830,4720
1378,10618,427,80210,81990,1780
1379,10618,428,3570,6120,2550
1380,10618,428,98700,99990,1290
1381,10618,428,135270,136840,1570
1382,10618,428,172400,174000,1600
1383,10618,429,2130,3120,990
1384,10618,438,60270,61780,1510
1385,10618,439,8390,10150,1760
1386,10618,439,38200,39850,1650
1387,10618,441,161260,162870,1610
1388,10618,442,2020,4070,2050
1389,10618,443,63950,66180,2230
1390,10618,445,5220,6880,1660
1391,10618,448,32460,33810,1350
1392,10618,448,73730,76190,2460
1393,10618,449,6790,8770,1980
1394,10618,451,100680,102310,1630
1395,10618,452,7410,11040,3630
1396,10618,455,102470,104080,1610
1397,10618,456,6590,8400,1810
1398,10618,458,91380,92780,1400
1399,10618,458,109310,111100,1790
1400,10618,459,6080,8030,1950
1401,10618,461,130110,132420,2310
1402,10618,462,9900,12250,2350
1403,10618,465,162760,166020,3260
1404,10618,466,4410,6290,1880
1405,10618,471,93680,95830,2150
1406,10618,472,2220,3450,1230
1407,10618,475,289830,291580,1750
1408,10618,476,3700,5240,1540
1409,10618,478,92500,94150,1650
1410,10618,479,7120,9010,1890
1411,10618,480,21030,22570,1540
1412,10618,481,257230,258850,1620
1413,10618,482,4750,6160,1410
1414,10618,485,105990,107680,1690
1415,10618,486,7710,9300,1590
1416,10618,487,187060,188350,1290
1417,10618,488,5120,6550,1430
1418,10618,492,112110,114990,2880
1419,10618,493,5380,7510,2130
1420,10618,493,126140,127470,1330
1421,10618,493,143120,144480,1360
1422,10618,494,4510,6320,1810
1423,10618,497,115250,116720,1470
1424,10618,497,124430,126280,1850
1425,10618,498,12250,15330,3080
1426,10618,499,313870,315360,1490
1427,10618,504,38560,40460,1900
1428,10618,504,84440,85630,1190
1429,10618,508,92850,94680,1830
1430,10618,509,5250,6710,1460
1431,10618,511,81680,82950,1270
1432,10618,511,117240,119010,1770
1433,10618,512,6340,9530,3190
1434,10618,514,162680,165480,2800
1435,10618,515,11640,13090,1450
1436,10618,515,18150,20110,1960
1437,10618,519,206080,207990,1910
1438,10618,520,5540,7230,1690
1439,10618,522,107420,109180,1760
1440,10618,523,12970,14720,1750
1441,10618,524,130440,132130,1690
1442,10618,525,5640,7570,1930
1443,10618,526,98810,101530,2720
1444,10618,527,3430,4740,1310
1445,10618,534,61140,63430,2290
1446,10618,535,6070,8040,1970
1447,10618,564,118530,120400,1870
1448,10618,565,5630,8570,2940
1449,10618,566,344620,346810,2190
1450,10618,567,7300,10190,2890
1451,10618,570,24450,26430,1980
1452,10618,571,5110,8980,3870
1453,10618,572,108890,110360,1470
1454,10618,573,3980,6020,2040
1455,10618,579,147800,149090,1290
1456,10618,580,3820,5830,2010
1457,10618,586,133240,135140,1900
1458,10618,587,5670,7440,1770
1459,10618,588,9270,10760,1490
1460,10618,589,4500,6060,1560
1461,10618,595,188260,190060,1800
1462,10618,596,4350,5780,1430
1463,10618,597,120840,122610,1770
1464,10618,598,7150,8540,1390
1465,10618,605,158470,161100,2630
1466,10618,606,4550,6450,1900
1467,10618,607,176980,178860,1880
1468,10618,608,5110,6630,1520
1469,10618,613,121450,123100,1650
1470,10618,614,4440,6030,1590
1471,10618,630,178560,180430,1870
1472,10618,631,10140,12350,2210
1473,10618,633,61540,64170,2630
1474,10618,634,8180,10780,2600
1475,10618,640,199710,202410,2700
1476,10618,641,9280,11380,2100
1477,10618,644,103290,106220,2930
1478,10618,645,11480,14160,2680
1479,10618,649,123660,125930,2270
1480,10618,650,7850,10130,2280
1481,10618,658,100180,101860,1680
1482,10618,659,4480,6060,1580
1483,10618,659,38330,39750,1420
1484,10618,660,7530,9190,1660
1485,10618,662,89830,91480,1650
1486,10618,663,5950,8800,2850
1487,10618,665,148760,150830,2070
1488,10618,666,5580,7210,1630
1489,10618,666,44200,45890,1690
1490,10618,669,153830,155770,1940
1491,10618,670,7060,9800,2740
1492,10618,671,307080,309070,1990
1493,10618,672,6790,8830,2040
1494,10618,673,27420,29290,1870
1495,10618,675,74990,76760,1770
1496,10618,676,6600,8320,1720
1497,10618,678,139280,141090,1810
1498,10618,679,5340,6900,1560
1499,10618,689,15450,16370,920
1500,10618,698,42690,44710,2020
1501,10618,699,8230,10210,1980
1502,10618,701,107280,109010,1730
1503,10618,702,6290,7920,1630
1504,10618,713,566260,568100,1840
1505,10618,713,576250,579160,2910
1506,10618,714,33840,35880,2040
1507,10618,715,5160,6580,1420
1508,10618,716,15470,17170,1700
1509,10618,721,154730,156340,1610
1510,10618,722,5460,7930,2470
1511,10618,727,175120,176590,1470
1512,10618,728,8060,17900,9840
1513,10618,728,179130,182630,3500
1514,10618,728,189050,193980,4930
1515,10618,731,51590,53410,1820
1516,10618,732,9030,11510,2480
1517,10618,735,180860,183020,2160
1518,10618,735,194270,196900,2630
1519,10618,736,30010,31380,1370
1520,10618,737,6110,8190,2080
1521,10618,742,220560,222170,1610
1522,10618,743,9030,11110,2080
1523,10618,753,107520,109220,1700
1524,10618,754,4400,6520,2120
1525,10618,756,195480,197890,2410
1526,10618,757,5960,7560,1600
1527,10618,768,61420,62980,1560
1528,10618,769,3330,4780,1450
1529,10618,769,142990,144400,1410
1530,10618,770,5690,7260,1570
1531,10618,775,93510,95310,1800
1532,10618,776,8300,10140,1840
1533,10618,778,44290,45620,1330
1534,10618,778,98330,99660,1330
1535,10618,779,118120,119670,1550
1536,10618,779,174180,175680,1500
1537,10618,781,201800,203630,1830
1538,10618,782,8110,8560,450
1539,10618,782,29140,32190,3050
1540,10618,787,90910,92540,1630
1541,10618,788,7450,9160,1710
1542,10618,788,106970,108360,1390
1543,10618,798,57450,58940,1490
1544,10618,799,6210,9150,2940
1545,10618,801,169360,172590,3230
1546,10618,802,29560,31580,2020
1547,10618,809,189310,195640,6330
1548,10618,810,236780,238700,1920
1549,10618,811,6620,8190,1570
1550,10618,816,113160,114530,1370
1551,10618,819,131500,133350,1850
1552,10618,820,7440,9260,1820
1553,10618,840,197110,198640,1530
1554,10618,841,9400,12070,2670
1555,10618,841,27580,28670,1090
1556,10618,846,214310,215680,1370
1557,10618,846,226460,228250,1790
1558,10618,847,4000,5430,1430
1559,10618,848,153230,154820,1590
1560,10618,849,4220,5890,1670
1561,10618,852,136550,138200,1650
1562,10618,853,4430,6370,1940
1563,10618,856,124050,125460,1410
1564,10618,857,2510,3860,1350
1565,10618,875,215920,217850,1930
1566,10618,876,6530,8330,1800
1567,10618,894,138100,139630,1530
1568,10618,895,4550,6670,2120
1569,10618,897,131880,133530,1650
1570,10618,898,5120,6700,1580
1571,10618,906,72630,74200,1570
1572,10618,907,7210,8610,1400
1573,10618,907,47150,57260,10110
1574,10618,907,59210,65450,6240
1575,10618,939,184280,185890,1610
1576,10618,940,5340,8100,2760
1577,10618,943,166640,168380,1740
1578,10618,944,4120,6430,2310
1579,10618,946,123640,126440,2800
1580,10618,947,5350,7790,2440
1581,10618,948,126220,127690,1470
1582,10618,949,5000,6940,1940
1583,10618,951,284730,286280,1550
1584,10618,952,6010,7670,1660
1585,10618,977,53840,55490,1650
1586,10618,978,4410,6340,1930
1587,10618,979,217260,219020,1760
1588,10618,980,5960,7750,1790
1589,10618,990,64390,66000,1610
1590,10618,991,5170,7320,2150
1591,10618,998,92900,94860,1960
1592,10618,999,8340,9840,1500
1593,10618,1004,130400,132130,1730
1594,10618,1005,2720,4190,1470
1595,10618,1006,13410,14910,1500
1596,10618,1014,188670,190510,1840
1597,10618,1015,1540,2710,1170
1598,10618,1025,157720,159860,2140
1599,10618,1026,7660,9450,1790
1600,10618,1026,67070,68930,1860
1601,10618,1027,10000,13050,3050
1602,10618,1032,77660,79270,1610
1603,10618,1033,2770,4190,1420
1604,10618,1033,15890,17180,1290
1605,10618,1036,111430,113400,1970
1606,10618,1037,3860,6310,2450
1607,10618,1038,129390,130940,1550
1608,10618,1039,4500,6210,1710
1609,10618,1039,35610,36970,1360
1610,10618,1042,94200,96050,1850
1611,10618,1043,5920,8940,3020
1612,10618,1046,155710,157320,1610
1613,10618,1047,16840,18530,1690
1614,10618,1049,148870,150510,1640
1615,10618,1050,3710,5290,1580
1616,10618,1051,156460,158010,1550
1617,10618,1052,3400,4890,1490
1618,10618,1054,67570,69160,1590
1619,10618,1055,2850,4670,1820
1620,10618,1058,14680,16770,2090
1621,10618,1059,4580,6630,2050
1622,10618,1059,38220,39840,1620
1623,10618,1059,44270,48070,3800
1624,10618,1067,89580,91050,1470
1625,10618,1068,4020,5280,1260
1626,10618,1079,74910,76900,1990
1627,10618,1080,2520,3910,1390
1628,10618,1088,243710,245160,1450
1629,10618,1089,3350,4610,1260
1630,10618,1092,106770,108450,1680
1631,10618,1093,8190,10520,2330
1632,10618,1097,111660,113450,1790
1633,10618,1098,3950,5820,1870
1634,10618,1099,274490,275810,1320
1635,10618,1100,8830,12760,3930
1636,10618,1116,110300,112030,1730
1637,10618,1118,6820,7120,300
1638,10618,1118,11260,11510,250
1639,10618,1118,12750,16210,3460
1640,10618,1123,157740,160200,2460
1641,10618,1125,5520,6990,1470
1642,10618,1127,22380,23900,1520
1643,10618,1128,4990,6380,1390
1644,10618,1130,140990,142600,1610
1645,10618,1131,5070,6360,1290
1646,10618,1134,51280,52660,1380
1647,10618,1135,2980,4370,1390
1648,10618,1142,94690,99110,4420
1649,10618,1143,4880,6440,1560
1650,10618,1147,229690,231360,1670
1651,10618,1148,5580,7330,1750
1652,10618,1152,155590,157870,2280
1653,10618,1153,5290,6700,1410
1654,10618,1164,193430,196080,2650
1655,10618,1165,5930,8470,2540
1656,10618,1172,34740,37120,2380
1657,10618,1172,44610,44870,260
1658,10618,1173,27720,31350,3630
1659,10618,1175,167750,169480,1730
1660,10618,1176,4890,6300,1410
1661,10618,1187,100850,102460,1610
1662,10618,1188,8100,9800,1700
1663,10618,1189,242260,247210,4950
1664,10618,1190,5670,5920,250
1665,10618,1190,22200,25870,3670
1666,10618,1190,41050,42840,1790
1667,10618,1190,48450,53040,4590
1668,10618,1193,188910,190920,2010
1669,10618,1194,1980,3560,1580
1670,10618,1198,56070,57720,1650
1671,10618,1199,3060,4460,1400
1672,10618,1202,101180,102720,1540
1673,10618,1203,2830,4230,1400
1674,10618,1223,166950,168630,1680
1675,10618,1224,8880,10130,1250
1676,10618,1230,234160,235670,1510
1677,10618,1231,8620,10130,1510
1678,10618,1233,242990,244610,1620
1679,10618,1234,4970,6290,1320
1680,10618,1239,146820,148500,1680
1681,10618,1240,4530,6090,1560
1682,10618,1252,301600,303000,1400
1683,10618,1253,4910,6470,1560
1684,10618,1256,116700,118380,1680
1685,10618,1257,3410,4730,1320
1686,10618,1266,30410,31870,1460
1687,10618,1267,3250,4600,1350
1688,10618,1270,8660,10700,2040
1689,10618,1271,14620,16060,1440
1690,10618,1273,174770,176370,1600
1691,10618,1274,6350,8150,1800
1692,10618,1286,135520,137270,1750
1693,10618,1287,4990,6300,1310
1694,10618,1288,81560,83020,1460
1695,10618,1289,6140,8150,2010
1696,10618,1296,98420,100430,2010
1697,10618,1297,4020,6940,2920
1698,10618,1298,131290,132770,1480
1699,10618,1299,9420,10630,1210
1700,10618,1301,114260,115770,1510
1701,10618,1302,3530,4980,1450
1702,10618,1303,118820,120390,1570
1703,10618,1304,5950,7330,1380
1704,10618,1305,108330,110230,1900
1705,10618,1306,4190,5790,1600
1706,10618,1313,44740,46150,1410
1707,10618,1314,4290,5920,1630
1708,10618,1319,122230,123790,1560
1709,10618,1320,6380,8650,2270
1710,10618,1320,172910,174490,1580
1711,10618,1321,5060,6580,1520
1712,10618,1329,95330,96920,1590
1713,10618,1330,3340,4650,1310
1714,10618,1334,95110,96640,1530
1715,10618,1335,10990,15860,4870
1716,10618,1338,116350,118250,1900
1717,10618,1339,4800,6480,1680
1718,10618,1344,134880,136410,1530
1719,10618,1345,5440,8520,3080
1720,10618,1348,26990,28470,1480
1721,10618,1349,4760,6330,1570
1722,10618,1356,140800,142280,1480
1723,10618,1357,6820,8340,1520
1724,10618,1357,89010,90660,1650
1725,10618,1357,182210,185390,3180
1726,10618,1358,6120,7880,1760
1727,10618,1362,99340,101380,2040
1728,10618,1363,6540,10020,3480
1729,10618,1374,166300,168600,2300
1730,10618,1375,5240,6790,1550
1731,10618,1375,54690,56450,1760
1732,10618,1376,5970,7540,1570
1733,10618,1380,22720,24470,1750
1734,10618,1380,92790,95620,2830
1735,10618,1381,2950,5140,2190
1736,10618,1381,19650,21430,1780
1737,10618,1381,61730,63510,1780
1738,10618,1381,66170,67600,1430
1739,10618,1383,68950,71100,2150
1740,10618,1384,6250,7870,1620
1741,10618,1385,59690,61330,1640
1742,10618,1387,118290,119880,1590
1743,10618,1387,148750,151040,2290
1744,10618,1388,3280,5130,1850
1745,10618,1388,23540,25010,1470
1746,10618,1388,59720,61150,1430
1747,10618,1394,134510,136040,1530
1748,10618,1395,3920,5460,1540
1749,10618,1433,59540,61080,1540
1750,10618,1434,4420,5960,1540
1751,10618,1435,188480,190090,1610
1752,10618,1436,6660,8730,2070
1753,10618,1470,185190,187270,2080
1754,10618,1471,7330,9180,1850
1755,10618,1471,63780,65880,2100
1756,10618,1471,83570,86650,3080
1757,10618,1471,94300,95920,1620
1758,10618,1471,99170,102620,3450
1759,10618,1483,180890,182580,1690
1760,10618,1484,44770,47700,2930
1761,10618,1485,211270,213080,1810
1762,10618,1486,23270,25510,2240
1763,10618,1488,163400,165080,1680
1764,10618,1489,5400,7120,1720
1765,10618,1490,20690,22170,1480
1766,10618,1495,102550,104280,1730
1767,10618,1496,5830,7790,1960
1768,10618,1504,63660,65390,1730
1769,10618,1505,5260,7010,1750
1770,10618,1506,158040,159870,1830
1771,10618,1507,5440,6970,1530
1772,10618,1518,98000,99850,1850
1773,10618,1519,6720,8910,2190
1774,10618,1519,127930,129880,1950
1775,10618,1520,5180,6740,1560
1776,10618,1521,146680,148400,1720
1777,10618,1522,11040,12490,1450
1778,10618,1531,93330,94980,1650
1779,10618,1532,6120,7840,1720
1780,10618,1549,136920,138580,1660
1781,10618,1550,11790,13430,1640
1782,10618,1553,210200,212380,2180
1783,10618,1554,5570,7120,1550
1784,10618,1563,170410,173080,2670
1785,10618,1566,8150,12440,4290
1786,10618,1566,51180,53250,2070
1787,10618,1568,139800,142440,2640
1788,10618,1569,6660,8350,1690
1789,10618,1575,109030,110780,1750
1790,10618,1576,8810,10560,1750
1791,10618,1578,63730,65420,1690
1792,10618,1579,8420,9980,1560
1793,10618,1581,172500,174270,1770
1794,10618,1582,4410,6320,1910
1795,10619,1441,157140,158640,1500
1796,10619,1442,3770,5300,1530
1797,10620,1465,5140,5140,0
1798,10620,3244,2010,2450,440
1799,10620,3263,1210,1530,320
1800,10620,4453,4390,4390,0
1801,10620,6331,2580,3060,480
1802,13000,1153,100390,102780,2390
1803,13103,8050,128050,130600,2550
1804,13103,8051,10370,11820,1450
1805,13103,9590,127890,149170,21280
1806,13103,15481,30170,32870,2700
1807,13103,15481,36710,39770,3060
1808,13103,15816,83710,86160,2450
1809,13103,15818,15050,17480,2430
1810,13103,16128,17000,20430,3430
1811,13103,16130,15450,17420,1970
1812,13103,17659,97800,100410,2610
1813,13103,17659,103980,106060,2080
1814,13103,18194,53700,56650,2950
1815,13103,18194,59940,62150,2210
1816,13103,18557,21940,24930,2990
1817,13103,18559,13500,15330,1830
1818,13105,16768,109050,111610,2560
1819,13105,19247,12950,15030,2080
1820,13105,20208,11210,13300,2090
1821,13105,20209,13490,15000,1510
1822,13105,20526,13870,16020,2150
1823,13105,20527,9330,11200,1870
1824,13105,20899,64330,66820,2490
1825,13105,20900,10370,11920,1550
1826,13107,164,65090,66030,940
1827,13107,164,67130,68850,1720
1828,13107,165,13680,15680,2000
1829,13107,321,36520,40040,3520
1830,13107,322,12100,14130,2030
1831,13107,434,38200,44430,6230
1832,13107,679,62180,66020,3840
1833,13107,680,17970,20350,2380
1834,13107,756,65660,69030,3370
1835,13107,757,5590,5680,90
1836,13107,3355,43170,46650,3480
1837,13107,3506,23260,26620,3360
1838,13107,3507,3770,6050,2280
1839,13107,3562,40300,43760,3460
1840,13107,3563,1950,4610,2660
1841,13107,3676,23370,26370,3000
1842,13107,3727,32280,35820,3540
1843,13107,3778,35560,38530,2970
1844,13107,3779,1030,2250,1220
1845,13107,3779,5970,8370,2400
1846,13107,3835,37380,40560,3180
1847,13107,3836,1100,1790,690
1848,13107,3836,3340,4200,860
1849,13107,3972,59880,65480,5600
1850,13107,3973,9870,11940,2070
1851,13107,4073,12150,15870,3720
1852,13107,4074,5100,8040,2940
1853,13107,4135,38640,41660,3020
1854,13107,4136,2780,5030,2250
1855,13107,4195,44880,48930,4050
1856,13107,4278,42790,45720,2930
1857,13107,4351,35270,38390,3120
1858,13107,4352,8210,10240,2030
1859,13107,4458,35230,37830,2600
1860,13107,4459,6720,8670,1950
1861,13107,4584,23710,27240,3530
1862,13107,4585,710,2690,1980
1863,13107,4585,6020,8310,2290
1864,13107,4651,17010,20590,3580
1865,13107,4728,31280,34480,3200
1866,13107,4729,4130,6320,2190
1867,13107,4838,67220,70440,3220
1868,13107,4839,7120,9320,2200
1869,13107,5190,114450,160380,45930
1870,13107,5191,160730,160840,110
1871,13107,5192,161680,164100,2420
1872,13107,5214,40660,44090,3430
1873,13107,5215,3400,6120,2720
1874,13107,5261,49330,52200,2870
1875,13107,5262,2030,4270,2240
1876,13107,5309,43520,47070,3550
1877,13107,5310,1970,4710,2740
1878,13107,5318,13980,17880,3900
1879,13107,5319,1530,2160,630
1880,13107,5319,6670,8890,2220
1881,13107,5395,41910,45150,3240
1882,13107,5396,200,6150,5950
1883,13107,5396,10290,12660,2370
1884,13107,5516,105600,108770,3170
1885,13107,5517,2190,4400,2210
1886,13107,5590,112070,125670,13600
1887,13107,5591,2290,4280,1990
1888,13107,5623,52410,55400,2990
1889,13107,5624,2620,4840,2220
1890,13107,5701,45080,47510,2430
1891,13107,5702,3980,5840,1860
1892,13107,5824,107390,147350,39960
1893,13107,5825,200,1680,1480
1894,13107,5825,5650,9230,3580
1895,13107,5921,102430,105940,3510
1896,13107,5922,1850,4760,2910
1897,13107,6037,27880,32110,4230
1898,13107,6038,9030,11050,2020
1899,13107,6263,47640,51460,3820
1900,13107,6264,10190,12480,2290
1901,13107,6376,58020,62730,4710
1902,13107,6377,9320,11330,2010
1903,13107,6490,40830,44510,3680
1904,13107,6491,190,480,290
1905,13107,6491,10700,12960,2260
1906,13107,6589,48420,52030,3610
1907,13107,6590,10380,12740,2360
1908,13107,6632,51190,54070,2880
1909,13107,6633,8380,10640,2260
1910,13107,6710,48060,51290,3230
1911,13107,6711,3480,6490,3010
1912,13107,6837,43080,46430,3350
1913,13107,6967,56040,59220,3180
1914,13107,6968,8750,10970,2220
1915,13107,7059,56830,60180,3350
1916,13107,7060,11050,13220,2170
1917,13107,7170,36080,39050,2970
1918,13107,7171,3810,6350,2540
1919,13107,7397,48790,55160,6370
1920,13107,7398,190,1550,1360
1921,13107,7497,29100,33590,4490
1922,13107,7502,111660,114650,2990
1923,13107,7544,79100,80990,1890
1924,13107,7625,40430,44940,4510
1925,13107,7718,41640,46110,4470
1926,13107,7802,59570,61790,2220
1927,13107,7840,43230,47730,4500
1928,13107,7841,190,260,70
1929,13107,7952,4440,7330,2890
1930,13107,7953,2450,4330,1880
1931,13107,8007,49710,51590,1880
1932,13107,8130,42380,44490,2110
1933,13107,8199,44330,48720,4390
1934,13107,8200,190,2440,2250
1935,13107,8306,30350,37690,7340
1936,13107,8307,190,2660,2470
1937,13107,8414,30170,32730,2560
1938,13107,8415,190,1650,1460
1939,13107,8514,30820,35580,4760
1940,13107,8626,29190,31870,2680
1941,13107,8627,190,4710,4520
1942,13107,8733,32040,36540,4500
1943,13107,8842,45760,50600,4840
1944,13107,8932,30660,35560,4900
1945,13107,9326,49980,54550,4570
1946,13107,9327,190,11090,10900
1947,13107,9397,75840,81380,5540
1948,13107,9398,590,1700,1110
1949,13107,9577,29250,31550,2300
1950,13107,9578,190,4130,3940
1951,13107,9827,52740,60230,7490
1952,13107,9903,42890,48330,5440
1953,13107,9904,190,3380,3190
1954,13107,10055,63500,65980,2480
1955,13107,10056,190,3300,3110
1956,13107,10154,30090,31970,1880
1957,13107,10155,190,4170,3980
1958,13107,10412,27450,31730,4280
1959,13107,10511,68980,72880,3900
1960,13107,10583,32450,34620,2170
1961,13107,10584,190,1290,1100
1962,13107,10663,34780,40190,5410
1963,13107,10886,47270,49890,2620
1964,13107,10887,52000,57330,5330
1965,13107,10888,190,1510,1320
1966,13107,11031,9240,11650,2410
1967,13107,11176,34510,36570,2060
1968,13107,11291,31280,34090,2810
1969,13107,11292,1360,4030,2670
1970,13107,11329,21020,23000,1980
1971,13107,11390,41110,54250,13140
1972,13107,11391,350,14460,14110
1973,13107,11610,87270,89290,2020
1974,13107,11651,55880,58280,2400
1975,13107,11715,34280,36380,2100
1976,13107,11822,91950,93820,1870
1977,13107,11925,19880,23630,3750
1978,13107,11926,1710,2460,750
1979,13107,11948,55570,57390,1820
1980,13107,12029,50330,52850,2520
1981,13107,12030,610,6020,5410
1982,13107,12049,61570,63680,2110
1983,13107,12067,196650,198770,2120
1984,13107,12093,21810,23430,1620
1985,13107,12133,31080,32580,1500
1986,13107,12175,27590,29920,2330
1987,13107,12249,34810,37830,3020
1988,13107,12266,71720,73690,1970
1989,13107,12364,28020,32860,4840
1990,13107,12365,550,5410,4860
1991,13107,12416,87110,89060,1950
1992,13107,12502,36610,38540,1930
1993,13107,13661,20150,24110,3960
1994,13107,14007,62110,63690,1580
1995,13107,14008,190,2650,2460
1996,13107,15042,25910,30060,4150
1997,13107,16011,35160,38570,3410
1998,13107,16012,15370,18320,2950
1999,13108,232,76080,79280,3200
2000,13108,324,71040,74470,3430
2001,13108,482,104080,107270,3190
2002,13108,798,87200,92470,5270
2003,13108,860,140970,143810,2840
2004,13108,861,1020,2890,1870
2005,13108,905,153230,156270,3040
2006,13108,907,860,3870,3010
2007,13108,971,79830,83200,3370
2008,13108,972,780,7980,7200
2009,13108,972,18990,21020,2030
2010,13108,1050,87440,90930,3490
2011,13108,1121,92900,96790,3890
2012,13108,1122,105260,171300,66040
2013,13108,1187,87330,90590,3260
2014,13108,1242,79980,83160,3180
2015,13108,1243,8660,10880,2220
2016,13108,1457,144140,147620,3480
2017,13108,8094,8850,11920,3070
2018,13108,8352,92820,94950,2130
2019,13108,8567,179150,181920,2770
2020,13108,8569,3140,3200,60
2021,13108,8641,92760,95050,2290
2022,13108,8643,13750,15770,2020
2023,13108,10853,77670,80570,2900
2024,13108,11206,48060,50780,2720
2025,13108,11207,11110,13740,2630
2026,13109,4471,50820,54760,3940
2027,13109,4472,11150,13400,2250
2028,13109,8660,6290,7940,1650
2029,13109,9977,80880,83730,2850
2030,13109,9978,6990,8700,1710
2031,13109,10226,35940,37880,1940
2032,13109,10226,66640,68440,1800
2033,13109,10226,76020,77660,1640
2034,13109,10562,146800,151410,4610
2035,13109,11840,970,980,10
2036,13109,12219,16540,18030,1490
2037,13109,12325,10590,11880,1290
2038,13109,12439,14500,15890,1390
2039,13109,12440,15180,15910,730
2040,13109,12807,13330,14780,1450
2041,13109,14112,11370,12560,1190
2042,13109,14230,24780,26010,1230
2043,13110,1367,13960,15620,1660
2044,13110,4709,45730,47290,1560
2045,13110,4709,61450,63080,1630
2046,13110,15259,14370,22350,7980
2047,13110,15363,8040,15260,7220
2048,13110,16595,11540,23260,11720
2049,15901,1,65880,67650,1770
2050,17101,609,91480,93140,1660
2051,17101,733,244180,245700,1520
2052,17101,733,425900,427270,1370
2053,17101,866,750730,753880,3150
2054,17101,1052,200880,202630,1750
2055,17101,1052,327480,328980,1500
2056,17101,1167,106420,108010,1590
2057,17101,1175,79200,80680,1480
2058,17101,1182,88390,89530,1140
2059,17101,1201,93780,95110,1330
2060,17101,1213,76590,77890,1300
2061,17101,1213,248380,249830,1450
2062,17101,1220,81200,82590,1390
2063,17101,1228,92370,93880,1510
2064,17101,1236,93010,94410,1400
2065,17101,1236,257620,259010,1390
2066,17101,1498,1523450,1524870,1420
2067,17101,2144,110980,112550,1570
2068,17102,1607,77040,78570,1530
2069,17102,1607,257750,259320,1570
2070,17102,1607,429640,431090,1450
2071,17102,1607,635460,636910,1450
2072,17102,1607,824930,826290,1360
2073,17102,1607,1022370,1023810,1440
2074,17102,1669,171110,172740,1630
2075,17102,1669,905950,907320,1370
2076,17102,1669,1109170,1110580,1410
2077,17103,849,194910,196480,1570
