Event,Device,Trip,Starttime,Endtime,Duration
1,92,29,490,540,50
2,92,43,14240,14990,750
3,501,8,83640,85210,1570
4,501,39,202780,203380,600
5,501,43,15630,16140,510
6,501,56,115540,116120,580
7,502,11,165290,167920,2630
8,502,24,111190,111670,480
9,502,29,119050,119520,470
10,502,46,105890,106380,490
11,502,52,114290,114890,600
12,502,58,109930,110340,410
13,502,73,93330,94020,690
14,502,80,107700,108430,730
15,502,112,93420,94050,630
16,502,123,96510,96940,430
17,502,130,120650,121180,530
18,502,137,118980,119490,510
19,502,142,97110,97600,490
20,502,154,100490,101040,550
21,502,159,129010,129490,480
22,502,179,98610,99040,430
23,502,184,20740,22030,1290
24,502,243,103730,104230,500
25,502,248,87330,88080,750
26,502,261,82030,82630,600
27,502,279,63470,66840,3370
28,502,285,100550,101000,450
29,502,293,111910,112330,420
30,502,299,110060,111090,1030
31,502,322,173020,173960,940
32,502,328,105100,106460,1360
33,502,332,112380,112840,460
34,502,661,39910,41300,1390
35,502,1004,210,240,30
36,551,69,94060,94650,590
37,551,561,27710,28400,690
38,551,579,23610,25570,1960
39,551,585,92300,92830,530
40,552,334,9980,10660,680
41,552,339,30220,31130,910
42,552,340,98540,99630,1090
43,552,348,89340,89940,600
44,552,353,15230,15900,670
45,552,356,12700,13570,870
46,552,360,90180,91150,970
47,552,362,111640,112290,650
48,552,369,145560,146240,680
49,552,374,139670,140560,890
50,552,374,168110,169530,1420
51,552,380,150490,151270,780
52,552,380,175570,176870,1300
53,552,382,162110,162840,730
54,552,382,185660,186970,1310
55,552,384,18580,19240,660
56,3268,43,477520,478190,670
57,3268,79,74680,75580,900
58,10107,76,248920,249440,520
59,10107,77,2610,2610,0
60,10121,4,1940,5210,3270
61,10122,312,145380,149250,3870
62,10122,339,478770,479380,610
63,10122,415,142070,142700,630
64,10122,459,149360,151530,2170
65,10122,668,5760,6370,610
66,10122,675,27890,28560,670
67,10122,679,24530,25090,560
68,10122,682,26340,26980,640
69,10122,723,181120,181750,630
70,10122,742,8260,9110,850
71,10122,744,9590,10140,550
72,10122,901,51090,51710,620
73,10122,920,3290,3670,380
74,10122,922,44980,46080,1100
75,10122,983,190160,190770,610
76,10122,995,153340,153920,580
77,10122,999,40880,41510,630
78,10122,1046,5590,6220,630
79,10122,1062,41060,41650,590
80,10122,1065,14710,15300,590
81,10122,1086,4940,6380,1440
82,10122,1088,10930,11570,640
83,10122,1123,75730,76350,620
84,10122,1126,47550,48150,600
85,10122,1296,5170,6050,880
86,10122,1297,50940,51650,710
87,10122,1373,130630,131440,810
88,10122,1379,505060,506240,1180
89,10122,1397,32150,32780,630
90,10125,4,2220,2220,0
91,10129,4643,10380,10590,210
92,10130,1243,17240,17970,730
93,10133,97,9390,10100,710
94,10138,13,1900,2030,130
95,10138,3110,2050,2610,560
96,10138,3333,5400,5400,0
97,10139,5015,1330,2060,730
98,10139,5019,14090,14840,750
99,10140,1025,5570,6170,600
100,10140,1026,1450,2260,810
101,10141,13,161520,162130,610
102,10141,554,9320,9750,430
103,10141,555,610,1200,590
104,10141,601,61160,61770,610
105,10141,602,340,500,160
106,10141,748,183400,184050,650
107,10150,168,23720,24200,480
108,10150,292,81940,82450,510
109,10150,366,80260,80780,520
110,10150,366,89570,90360,790
111,10150,509,13810,14260,450
112,10150,518,110100,110660,560
113,10150,520,5430,5970,540
114,10150,542,11270,11860,590
115,10150,962,12520,13110,590
116,10150,966,61160,62170,1010
117,10150,1554,17660,18220,560
118,10150,1555,2430,2720,290
119,10150,1952,24900,25560,660
120,10150,2400,16010,16540,530
121,10150,2425,40080,40610,530
122,10150,2472,33790,34350,560
123,10150,2593,14780,15370,590
124,10150,2854,25030,25530,500
125,10150,3087,118810,119490,680
126,10150,3088,670,890,220
127,10150,3145,8830,9510,680
128,10150,3506,31210,31800,590
129,10150,3557,22150,22720,570
130,10150,3850,3530,4020,490
131,10150,3851,1250,1930,680
132,10150,4040,500,1140,640
133,10150,4067,53920,54720,800
134,10150,4216,28690,29190,500
135,10150,4602,3730,4020,290
136,10150,5083,5330,5970,640
137,10150,5187,2440,2560,120
138,10150,5290,30040,30630,590
139,10150,5291,5760,5910,150
140,10150,5473,10420,11960,1540
141,10153,958,1690,1780,90
142,10155,633,70910,71690,780
143,10155,659,58360,61560,3200
144,10155,1051,46810,47560,750
145,10155,1148,13660,14690,1030
146,10155,1279,7200,7220,20
147,10155,1455,2780,3310,530
148,10160,710,115050,116290,1240
149,10160,710,127120,128030,910
150,10160,3122,1130,1150,20
151,10160,3699,330,960,630
152,10161,989,42710,43360,650
153,10161,2166,69090,69730,640
154,10161,2184,86500,87130,630
155,10161,2185,1450,3560,2110
156,10164,165,49160,49610,450
157,10164,186,51230,51860,630
158,10164,187,2190,2620,430
159,10164,194,51380,51800,420
160,10164,194,60290,62100,1810
161,10164,300,66590,67480,890
162,10164,357,37500,38010,510
163,10164,523,43210,43770,560
164,10164,630,32020,32510,490
165,10164,702,66860,67320,460
166,10164,736,59340,59890,550
167,10164,1227,91070,91540,470
168,10164,1624,121610,122240,630
169,10164,1887,38880,39460,580
170,10164,1963,25770,26240,470
171,10164,2174,950,980,30
172,10165,963,57730,58390,660
173,10165,963,75760,76570,810
174,10165,966,119400,120040,640
175,10165,1245,18960,20550,1590
176,10165,1351,100160,100630,470
177,10165,1382,87090,87560,470
178,10165,1411,6300,7180,880
179,10165,1429,94720,95390,670
180,10165,1433,7880,9580,1700
181,10165,1468,183620,184200,580
182,10165,1472,83090,83660,570
183,10165,1473,182380,183190,810
184,10165,1477,80510,80980,470
185,10165,1479,120610,121160,550
186,10165,1484,91330,91860,530
187,10165,1491,160010,160510,500
188,10165,1536,86500,87020,520
189,10165,1547,303040,303660,620
190,10165,1548,197310,197810,500
191,10165,1558,135310,136340,1030
192,10165,1564,145770,146630,860
193,10165,1591,4240,5200,960
194,10165,1649,4800,5500,700
195,10173,1649,11330,11520,190
196,10176,323,19210,19480,270
197,10176,604,8190,8370,180
198,10176,667,1460,1600,140
199,10176,2880,19560,19610,50
200,10176,3348,37400,37590,190
201,10176,3543,18530,18710,180
202,10176,3553,20390,20640,250
203,10176,3590,35990,36040,50
204,10176,5127,18790,18970,180
205,10176,5338,15630,15660,30
206,10204,246,200,660,460
207,10204,246,1940,1960,20
208,10204,335,65970,66730,760
209,10204,469,55220,55830,610
210,10204,586,290,300,10
211,10204,1525,268690,269840,1150
212,10204,1530,36440,37760,1320
213,10204,1530,77850,79850,2000
214,10204,1615,6020,6670,650
215,10204,1615,134060,135500,1440
216,10204,3079,23180,23770,590
217,10204,3079,33800,34390,590
218,10204,3079,44140,49430,5290
219,10204,3079,58860,59510,650
220,10204,3079,70960,71550,590
221,10204,3079,85740,86330,590
222,10204,3079,136920,137590,670
223,10204,3086,3200,3830,630
224,10204,3168,76560,77070,510
225,10204,3169,35490,36120,630
226,10204,3174,141780,142350,570
227,10204,3174,214050,214690,640
228,10204,3174,274220,274910,690
229,10204,3176,8970,9660,690
230,10204,3179,80250,80880,630
231,10204,3179,151310,152000,690
232,10204,3179,211490,212120,630
233,10204,3179,264870,265540,670
234,10204,3181,21310,21880,570
235,10204,3181,75670,76440,770
236,10204,3182,75550,76120,570
237,10204,3182,145870,146580,710
238,10204,3182,205110,205660,550
239,10204,3184,35970,36580,610
240,10204,3184,91930,92500,570
241,10204,3187,70740,71430,690
242,10204,3187,129960,130550,590
243,10204,3187,187060,187770,710
244,10204,3189,117930,118560,630
245,10204,3189,177650,178280,630
246,10204,3190,19990,20660,670
247,10204,3190,81630,82220,590
248,10204,3190,142570,143260,690
249,10204,3190,195240,195940,700
250,10204,3192,25010,25620,610
251,10204,3194,36250,36860,610
252,10204,3200,16830,17400,570
253,10204,3201,1950,2480,530
254,10204,3202,14660,15390,730
255,10204,3202,82070,82820,750
256,10204,3202,140090,140780,690
257,10204,3203,8580,9170,590
258,10204,3205,21480,22070,590
259,10204,3205,74240,74910,670
260,10204,3206,62200,62790,590
261,10204,3206,122800,123310,510
262,10204,3206,201280,201910,630
263,10204,3209,32430,33180,750
264,10204,3209,88090,88740,650
265,10204,3233,47520,48070,550
266,10204,3233,119160,119790,630
267,10204,3233,180480,181170,690
268,10204,3233,257440,258150,710
269,10204,3234,19900,20530,630
270,10204,3234,67880,68570,690
271,10204,3235,14430,15030,600
272,10204,3235,84020,84630,610
273,10204,3235,142980,143570,590
274,10204,3235,220480,221070,590
275,10204,3236,30620,31150,530
276,10204,3237,57320,58370,1050
277,10204,3238,74580,75630,1050
278,10205,254,62960,63580,620
279,10205,763,460,990,530
280,10205,773,430,790,360
281,10205,937,290,370,80
282,10205,953,14650,15190,540
283,10205,953,24510,25980,1470
284,10205,1213,4280,4280,0
285,10205,1266,58970,60010,1040
286,10205,1321,64150,64800,650
287,10205,1423,69550,70750,1200
288,10205,1433,95870,96220,350
289,10205,1540,60550,61160,610
290,10205,1647,97450,98040,590
291,10205,1653,177720,178650,930
292,10205,1654,83350,83830,480
293,10205,1689,8450,9160,710
294,10205,1689,78590,81140,2550
295,10205,1790,313020,313710,690
296,10205,1906,240,250,10
297,10205,1919,1650,5210,3560
298,10207,569,310,310,0
299,10207,1281,99860,100440,580
300,10207,2564,8840,9410,570
301,10207,3108,7620,8330,710
302,10207,3110,5300,6400,1100
303,10222,352,97840,98400,560
304,10222,352,139990,140680,690
305,10222,2653,136890,137770,880
306,10222,3098,39620,40030,410
307,10222,3099,2520,3790,1270
308,10502,1162,5210,5210,0
309,10502,1339,69630,71020,1390
310,10502,1465,67780,70270,2490
311,10502,1534,12020,12710,690
312,10502,1534,20650,22360,1710
313,10502,1557,68690,69300,610
314,10502,1675,7070,7530,460
315,10502,1787,62920,63520,600
316,10502,1901,13700,14570,870
317,10502,2145,1000,1230,230
318,10502,2226,380,380,0
319,10502,2393,920,920,0
320,10502,2799,5760,6290,530
321,10502,2799,10740,11310,570
322,10502,2861,530,640,110
323,10502,3225,540,1110,570
324,10502,3318,6130,6620,490
325,10502,3319,2970,4400,1430
326,10510,2935,61890,64230,2340
327,10557,1971,182880,183560,680
328,10557,1971,224880,226670,1790
329,10557,1981,84140,84830,690
330,10557,1982,248490,249140,650
331,10557,1986,20280,20880,600
332,10557,1986,86550,88180,1630
333,10557,1991,5460,6140,680
334,10557,1991,95860,98430,2570
335,10557,2070,152490,153090,600
336,10557,2070,181040,184060,3020
337,10570,6021,63790,65600,1810
338,10571,3114,28760,29210,450
339,10571,3114,35740,36330,590
340,10571,3116,113840,114720,880
341,10571,3122,30700,31190,490
342,10571,3135,1280,2570,1290
343,10572,20,94170,94620,450
344,10572,21,2030,2650,620
345,10572,25,86750,87270,520
346,10572,26,3630,4030,400
347,10572,27,80540,81040,500
348,10572,40,90770,91290,520
349,10572,41,2980,4400,1420
350,10572,42,95710,96090,380
351,10572,46,109450,109950,500
352,10572,47,2860,4100,1240
353,10572,48,94800,95170,370
354,10572,52,94080,94540,460
355,10572,61,98200,98710,510
356,10572,66,86410,86880,470
357,10572,72,80880,81330,450
358,10572,74,95180,95660,480
359,10572,75,1500,2320,820
360,10572,98,78850,79320,470
361,10572,99,2240,2780,540
362,10572,107,103690,104160,470
363,10572,109,75360,75930,570
364,10572,134,104010,104430,420
365,10572,135,1680,2990,1310
366,10572,146,84560,85010,450
367,10572,151,86870,87370,500
368,10572,161,81390,81850,460
369,10572,173,110140,110640,500
370,10572,174,3310,3950,640
371,10572,175,101430,101820,390
372,10572,180,88890,89350,460
373,10572,183,122930,123380,450
374,10572,185,133740,134210,470
375,10572,186,2100,6090,3990
376,10572,206,84690,85170,480
377,10572,207,4800,5910,1110
378,10572,208,88720,89170,450
379,10572,215,86310,86830,520
380,10572,224,118630,119070,440
381,10572,225,3470,6720,3250
382,10573,456,121600,122810,1210
383,10573,616,68410,69350,940
384,10574,973,12680,13330,650
385,10574,974,1830,3190,1360
386,10574,1564,8850,9480,630
387,10574,1987,8980,9510,530
388,10574,2021,13070,13760,690
389,10574,2059,9590,10120,530
390,10574,2127,7320,7830,510
391,10574,2823,10530,11120,590
392,10574,2824,2810,3620,810
393,10574,2983,1530,2310,780
394,10574,2990,3840,7250,3410
395,10574,3142,41900,42420,520
396,10574,3143,3100,3430,330
397,10574,3446,27160,27860,700
398,10575,363,8370,8590,220
399,10575,1675,10640,10870,230
400,10575,1981,11440,11550,110
401,10584,22,6690,7270,580
402,10584,24,27760,28400,640
403,10584,44,31340,32020,680
404,10584,46,33640,34310,670
405,10584,48,30340,30960,620
406,10584,51,39370,39940,570
407,10584,76,33510,34190,680
408,10584,76,76790,79300,2510
409,10584,79,1290,2170,880
410,10584,89,28160,28700,540
411,10584,92,27740,28370,630
412,10584,93,3550,3690,140
413,10584,121,25030,25590,560
414,10584,125,30600,31150,550
415,10584,127,29820,30430,610
416,10584,130,25180,25740,560
417,10584,149,27710,28330,620
418,10584,153,25950,26560,610
419,10584,159,26800,27340,540
420,10584,165,54230,54840,610
421,10584,179,36360,36980,620
422,10584,181,27350,27970,620
423,10584,184,30280,30810,530
424,10584,198,28950,29450,500
425,10584,202,25090,25570,480
426,10584,208,26850,27440,590
427,10584,210,4960,5940,980
428,10584,212,61070,61710,640
429,10584,214,29570,30130,560
430,10584,215,10500,11070,570
431,10584,229,27060,27670,610
432,10584,235,25420,26030,610
433,10584,236,2920,3460,540
434,10584,243,34090,34800,710
435,10584,266,25520,26140,620
436,10584,279,26590,27120,530
437,10584,282,28890,29410,520
438,10584,288,3500,5340,1840
439,10584,304,26720,27410,690
440,10584,310,22760,23360,600
441,10584,311,16000,16720,720
442,10584,319,27910,28460,550
443,10584,325,26830,27410,580
444,10584,327,29370,31780,2410
445,10584,348,24500,25070,570
446,10584,349,5200,5650,450
447,10584,356,32460,33030,570
448,10584,368,30810,31310,500
449,10584,388,31010,31560,550
450,10584,393,22780,23310,530
451,10584,400,30450,31020,570
452,10584,402,32390,32950,560
453,10584,406,3730,4570,840
454,10584,422,5730,6250,520
455,10584,423,1960,2120,160
456,10584,425,28780,29360,580
457,10584,428,31000,31570,570
458,10584,431,16880,17430,550
459,10584,457,42430,42960,530
460,10584,459,26630,27260,630
461,10584,463,35400,35930,530
462,10584,472,25080,25640,560
463,10584,476,30870,31370,500
464,10584,482,23790,24340,550
465,10584,487,26230,26920,690
466,10584,493,25540,26130,590
467,10584,584,28420,29020,600
468,10584,591,30340,30950,610
469,10584,593,48030,48590,560
470,10584,612,27240,27790,550
471,10584,613,1610,2190,580
472,10584,617,25500,26070,570
473,10584,622,30400,31020,620
474,10584,625,64680,65290,610
475,10584,639,34290,34900,610
476,10584,644,20310,20900,590
477,10584,648,32510,33050,540
478,10584,650,32240,32850,610
479,10584,652,52340,52970,630
480,10584,672,24370,24990,620
481,10584,676,27510,28080,570
482,10584,677,1860,2480,620
483,10584,678,29040,29660,620
484,10584,680,26830,27380,550
485,10584,703,16430,17030,600
486,10584,706,67930,68510,580
487,10584,711,29890,30460,570
488,10584,712,2190,3310,1120
489,10584,715,24790,25390,600
490,10584,737,30250,30810,560
491,10584,761,17010,17520,510
492,10584,762,3460,3910,450
493,10584,765,29730,30570,840
494,10584,766,2990,3670,680
495,10584,768,28890,29570,680
496,10584,772,27950,28540,590
497,10584,773,1470,1690,220
498,10584,780,26900,27410,510
499,10584,782,30450,30980,530
500,10584,783,2690,2810,120
501,10584,791,51730,52290,560
502,10584,798,4110,4800,690
503,10584,803,29970,30530,560
504,10584,823,31450,32080,630
505,10584,824,2700,2970,270
506,10584,830,27260,27850,590
507,10584,832,31190,31850,660
508,10584,862,27780,28380,600
509,10584,866,30730,31360,630
510,10584,867,12910,13840,930
511,10584,871,26350,26950,600
512,10584,873,42410,42910,500
513,10584,878,25660,26270,610
514,10584,885,30460,31080,620
515,10584,893,27990,28520,530
516,10584,894,5350,6530,1180
517,10584,895,28830,29360,530
518,10584,917,5090,5270,180
519,10584,918,27150,27720,570
520,10584,920,29350,30050,700
521,10584,925,92370,92930,560
522,10584,930,35400,36000,600
523,10584,933,24460,25030,570
524,10584,953,25110,25690,580
525,10584,954,3290,3420,130
526,10584,957,27470,28060,590
527,10584,960,26640,27230,590
528,10584,967,36860,37470,610
529,10584,980,16660,17210,550
530,10584,982,27760,28510,750
531,10584,985,23560,24140,580
532,10584,987,27130,27670,540
533,10584,1004,6380,6930,550
534,10584,1008,26350,27000,650
535,10584,1010,25950,26550,600
536,10584,1012,40090,40640,550
537,10584,1017,33400,33980,580
538,10584,1026,26280,26930,650
539,10584,1029,28250,28820,570
540,10584,1033,26060,26690,630
541,10584,1036,48380,49080,700
542,10584,1036,59600,60450,850
543,10584,1042,6400,6900,500
544,10584,1043,5230,6030,800
545,10584,1073,64960,65500,540
546,10584,1076,27930,28530,600
547,10584,1080,26400,26950,550
548,10584,1104,26890,27480,590
549,10584,1107,23260,23840,580
550,10584,1111,27350,28030,680
551,10584,1129,24960,25490,530
552,10584,1132,25590,26160,570
553,10584,1137,10080,10550,470
554,10584,1139,29750,30370,620
555,10584,1140,7150,8080,930
556,10584,1144,26200,26810,610
557,10584,1145,2990,4750,1760
558,10584,1146,28840,29390,550
559,10584,1166,16880,17390,510
560,10585,1643,62080,63180,1100
561,10586,339,27250,27850,600
562,10587,895,1250,2460,1210
563,10587,1366,14990,15480,490
564,10587,1502,750,840,90
565,10587,1539,2360,2850,490
566,10587,1590,1090,1170,80
567,10587,1658,171020,171650,630
568,10587,1659,4240,4510,270
569,10587,1695,52490,53200,710
570,10587,1811,45650,46150,500
571,10587,1812,3030,3640,610
572,10587,1871,54750,55440,690
573,10587,1989,7490,8130,640
574,10587,2050,95540,96780,1240
575,10587,2053,2750,2780,30
576,10587,2077,44800,45320,520
577,10587,2078,1930,2490,560
578,10587,2089,35300,35930,630
579,10587,2090,34180,34800,620
580,10587,2221,151710,152330,620
581,10587,2316,25000,25580,580
582,10587,2380,53650,54080,430
583,10587,2381,5040,5920,880
584,10587,2425,13120,13640,520
585,10587,2447,9260,9790,530
586,10587,2448,2820,4210,1390
587,10587,2476,20900,21530,630
588,10587,2477,3620,5750,2130
589,10587,2478,26040,26550,510
590,10587,2479,4470,4470,0
591,10587,2482,21040,21620,580
592,10587,2534,3550,4290,740
593,10587,2547,27260,27870,610
594,10587,2548,2240,2820,580
595,10587,2564,33860,34390,530
596,10587,2745,38550,39000,450
597,10587,3040,21930,22500,570
598,10587,3205,3760,4310,550
599,10587,3245,66520,66990,470
600,10587,3245,75580,76230,650
601,10587,3246,4740,5110,370
602,10587,3285,46070,46530,460
603,10587,3285,74690,75430,740
604,10587,3301,45220,45670,450
605,10587,3302,2150,2550,400
606,10587,3359,9750,10320,570
607,10587,3431,48670,49080,410
608,10587,3432,2680,3430,750
609,10587,3459,34680,35140,460
610,10587,3468,46210,46700,490
611,10587,3541,45700,46170,470
612,10587,3541,63080,63670,590
613,10587,3558,10930,11520,590
614,10587,3674,27230,27800,570
615,10587,3675,1930,3060,1130
616,10587,3684,40300,40710,410
617,10587,3977,12360,12910,550
618,10587,3989,9670,11280,1610
619,10587,4052,47300,47730,430
620,10587,4062,52550,53060,510
621,10587,4063,7070,7790,720
622,10587,4065,16220,16770,550
623,10587,4066,2800,3650,850
624,10587,4145,19130,19650,520
625,10587,4150,4400,4530,130
626,10587,4711,51780,52220,440
627,10587,4712,2300,3220,920
628,10587,4719,84660,85190,530
629,10587,4720,12810,13380,570
630,10587,4930,42750,43220,470
631,10587,5011,50290,50780,490
632,10587,5012,2150,2720,570
633,10587,5146,46470,46890,420
634,10587,5147,4880,5490,610
635,10587,5281,24980,25510,530
636,10587,5282,2620,3950,1330
637,10587,5623,41940,42400,460
638,10592,1929,157370,158050,680
639,10592,1933,141600,142320,720
640,10592,1937,119600,120210,610
641,10592,1939,148380,149000,620
642,10593,756,22040,22290,250
643,10593,792,5500,5810,310
644,10593,816,5690,6720,1030
645,10594,1081,39400,39450,50
646,10605,5561,245930,247140,1210
647,10605,5957,110740,111420,680
648,10605,7467,81290,84980,3690
649,10605,7468,3780,4650,870
650,10605,7476,92420,92960,540
651,10605,7477,4380,4430,50
652,10605,8923,37810,38280,470
653,10605,8924,3310,3860,550
654,10607,225,105330,105890,560
655,10607,319,103850,104550,700
656,10607,320,4740,6640,1900
657,10607,352,184330,184940,610
658,10607,352,197960,198670,710
659,10607,353,102810,103270,460
660,10607,355,221000,221620,620
661,10607,355,232040,233140,1100
662,10607,356,105410,105980,570
663,10607,359,167880,168490,610
664,10607,359,178470,180220,1750
665,10607,360,116250,116920,670
666,10607,360,133140,133890,750
667,10607,361,246830,247380,550
668,10607,361,258370,259200,830
669,10607,362,123720,124320,600
670,10607,362,147860,148720,860
671,10607,367,297440,298020,580
672,10607,367,308870,310840,1970
673,10607,371,6510,6970,460
674,10607,371,16780,17480,700
675,10607,388,197580,198200,620
676,10607,388,206230,207050,820
677,10607,391,99310,99870,560
678,10607,391,117230,118280,1050
679,10607,393,194630,195260,630
680,10607,393,204230,205100,870
681,10607,394,99610,100170,560
682,10607,395,1590,2300,710
683,10607,396,193960,194620,660
684,10607,396,203380,204160,780
685,10607,402,97310,97920,610
686,10607,402,158050,158870,820
687,10607,409,200830,201590,760
688,10607,409,213920,214690,770
689,10607,412,101270,101860,590
690,10607,412,160170,161030,860
691,10607,428,212330,213000,670
692,10607,428,223320,224060,740
693,10607,429,106920,107510,590
694,10607,429,116050,117200,1150
695,10607,431,274160,274800,640
696,10607,431,286050,286850,800
697,10607,432,108420,109070,650
698,10607,432,126690,127550,860
699,10607,436,249190,249860,670
700,10607,436,260610,262260,1650
701,10607,437,104650,105240,590
702,10607,437,113250,114950,1700
703,10607,438,240800,241500,700
704,10607,438,251840,254410,2570
705,10607,439,95510,96080,570
706,10607,439,139530,140270,740
707,10607,440,264440,265100,660
708,10607,440,276230,277380,1150
709,10607,443,88140,88800,660
710,10607,443,145710,146430,720
711,10607,459,373270,373850,580
712,10607,459,384240,385210,970
713,10607,461,109920,110440,520
714,10607,461,117640,118310,670
715,10607,463,236550,237240,690
716,10607,463,248450,249800,1350
717,10607,464,85830,86410,580
718,10607,465,4260,5060,800
719,10607,468,217990,218610,620
720,10607,468,229210,229920,710
721,10607,471,98900,99490,590
722,10607,471,140450,141170,720
723,10607,473,204750,205350,600
724,10607,473,216170,217590,1420
725,10607,474,104850,105470,620
726,10607,474,172610,173790,1180
727,10607,476,198080,198660,580
728,10607,476,209250,209940,690
729,10607,479,95320,95960,640
730,10607,480,7670,8380,710
731,10607,500,232620,233290,670
732,10607,500,243830,244530,700
733,10607,501,96930,97580,650
734,10607,501,106070,106740,670
735,10607,506,216640,217250,610
736,10607,506,227510,229900,2390
737,10607,508,95880,96470,590
738,10607,508,119220,119950,730
739,10607,674,238100,238720,620
740,10607,674,248800,249540,740
741,10607,675,89460,90090,630
742,10607,675,126030,126880,850
743,10607,678,257040,257620,580
744,10607,678,268100,269480,1380
745,10607,679,88820,89410,590
746,10607,679,123100,123800,700
747,10607,682,220290,220870,580
748,10607,682,231010,232580,1570
749,10607,684,107000,107520,520
750,10607,684,113460,114090,630
751,10607,685,221530,222190,660
752,10607,685,231860,232530,670
753,10607,688,95210,95750,540
754,10607,688,105370,105800,430
755,10607,692,223830,224400,570
756,10607,692,234810,236180,1370
757,10607,693,108070,108670,600
758,10607,693,125170,125910,740
759,10607,709,269990,270720,730
760,10607,709,282660,283730,1070
761,10607,710,125760,126470,710
762,10607,710,159560,160480,920
763,10607,712,241880,242490,610
764,10607,712,252760,254490,1730
765,10607,713,94660,95260,600
766,10607,713,110940,111670,730
767,10607,715,267270,267960,690
768,10607,715,278550,281710,3160
769,10607,716,103360,103910,550
770,10607,716,121030,121710,680
771,10607,720,194340,194960,620
772,10607,720,204750,207230,2480
773,10607,721,93090,93630,540
774,10607,721,102350,103650,1300
775,10607,722,233300,233910,610
776,10607,722,251920,252630,710
777,10607,723,104740,105350,610
778,10607,723,114140,114790,650
779,10607,726,289700,290480,780
780,10607,726,311870,314200,2330
781,10607,731,104580,105180,600
782,10607,731,115190,115910,720
783,10607,736,330440,331240,800
784,10607,736,344030,344810,780
785,10607,738,104840,105540,700
786,10607,738,215980,216710,730
787,10607,741,288960,289590,630
788,10607,741,304170,304910,740
789,10607,742,101230,101750,520
790,10607,742,116280,116940,660
791,10607,744,244900,245530,630
792,10607,744,258310,259010,700
793,10607,745,108330,108890,560
794,10607,745,118980,120870,1890
795,10607,747,182400,183110,710
796,10607,747,194070,195490,1420
797,10607,751,9820,10280,460
798,10607,751,51060,51830,770
799,10607,767,290120,290810,690
800,10607,767,301760,302650,890
801,10607,768,98580,99150,570
802,10607,768,121010,121760,750
803,10607,771,184020,184590,570
804,10607,771,195560,197920,2360
805,10607,772,118220,118890,670
806,10607,772,153970,154640,670
807,10607,783,176360,176960,600
808,10607,784,9930,10860,930
809,10607,785,241340,241960,620
810,10607,785,264730,265430,700
811,10607,786,102150,102750,600
812,10607,802,446170,447110,940
813,10607,802,459330,460250,920
814,10607,803,130200,130760,560
815,10607,803,180990,183270,2280
816,10607,804,390710,391380,670
817,10607,804,402240,402930,690
818,10607,805,100770,101350,580
819,10607,805,145690,146520,830
820,10607,820,343690,344410,720
821,10607,820,356870,357690,820
822,10607,821,111620,112220,600
823,10607,821,141550,142340,790
824,10607,823,379030,379780,750
825,10607,823,390930,391790,860
826,10607,824,117420,118010,590
827,10607,824,128480,129210,730
828,10607,825,254270,254980,710
829,10607,825,266730,267400,670
830,10607,826,113070,113680,610
831,10607,826,190740,191470,730
832,10607,830,329990,330790,800
833,10607,830,346130,351150,5020
834,10607,834,109090,109740,650
835,10607,834,129300,130040,740
836,10607,844,253010,253660,650
837,10607,844,265700,266430,730
838,10607,845,95840,96480,640
839,10607,845,115490,116440,950
840,10607,848,189730,190370,640
841,10607,848,201040,202290,1250
842,10607,850,104390,105120,730
843,10607,850,153560,154410,850
844,10607,853,256210,256850,640
845,10607,853,267190,267880,690
846,10607,854,102220,102750,530
847,10607,854,115050,116730,1680
848,10607,857,249510,250190,680
849,10607,857,261840,262930,1090
850,10607,858,148950,149530,580
851,10607,859,10030,10930,900
852,10607,860,338020,338840,820
853,10607,860,369770,370460,690
854,10607,861,101880,102450,570
855,10607,861,144550,146400,1850
856,10607,873,257270,258070,800
857,10607,877,141930,142580,650
858,10607,878,1300,3000,1700
859,10607,887,289100,289760,660
860,10607,887,301980,302770,790
861,10607,891,107500,108220,720
862,10607,891,121120,122180,1060
863,10607,893,431640,432360,720
864,10607,893,443130,444660,1530
865,10607,894,104780,105370,590
866,10607,894,180480,181640,1160
867,10607,896,285170,285770,600
868,10607,896,296690,297420,730
869,10607,897,112010,112710,700
870,10607,897,125470,126240,770
871,10607,905,434890,435760,870
872,10607,905,448630,449860,1230
873,10607,906,122390,123150,760
874,10607,906,133740,134510,770
875,10607,908,295630,296300,670
876,10607,908,307840,308590,750
877,10607,909,99270,100140,870
878,10607,909,124940,126030,1090
879,10607,912,262310,262960,650
880,10607,912,273310,274710,1400
881,10607,914,95820,96380,560
882,10607,914,109790,111670,1880
883,10607,915,308910,309620,710
884,10607,915,322100,323100,1000
885,10607,916,101690,102380,690
886,10607,917,8170,9310,1140
887,10607,918,101120,101650,530
888,10607,919,2040,2860,820
889,10607,935,443680,444460,780
890,10607,936,92310,92790,480
891,10607,936,105670,106450,780
892,10607,939,273110,273780,670
893,10607,939,312800,313690,890
894,10607,940,104160,104930,770
895,10607,940,118300,120490,2190
896,10607,944,457840,459620,1780
897,10607,945,121910,122730,820
898,10607,945,142000,143000,1000
899,10607,950,170870,171820,950
900,10607,1407,168760,169360,600
901,10607,1408,460,1300,840
902,10607,1609,169850,170450,600
903,10607,1610,200,810,610
904,10607,1613,1520,2260,740
905,10607,4640,202180,202810,630
906,10607,5505,1050,2000,950
907,10612,1484,5150,5210,60
908,10612,2019,6120,6150,30
909,10612,2473,6350,6870,520
910,10612,2480,13600,14100,500
911,10612,2481,4850,5470,620
912,10612,3083,6430,6440,10
913,10612,3506,3960,4240,280
914,10612,3535,11120,11700,580
915,10612,3536,6750,7510,760
916,10612,4206,13460,14050,590
917,10612,5537,5880,6180,300
918,10612,5624,4010,4010,0
919,10612,5701,420,440,20
920,10612,5701,1530,1560,30
921,10612,5752,1020,1020,0
922,10612,5766,52070,52770,700
923,10612,5766,59000,59700,700
924,10612,5767,3620,3620,0
925,10612,5840,420,420,0
926,10612,5848,190,250,60
927,10612,5860,2860,2860,0
928,10612,5860,4110,4110,0
929,10612,5919,660,660,0
930,10616,336,16410,16990,580
931,10616,337,660,1200,540
932,10616,943,8690,9320,630
933,10616,943,15820,16600,780
934,10616,977,36940,40070,3130
935,10616,978,72960,74090,1130
936,10617,231,7820,7820,0
937,10618,55,100820,101500,680
938,10618,56,99600,100300,700
939,10618,80,118010,118680,670
940,10618,112,95420,96090,670
941,10618,113,148640,149300,660
942,10618,122,142090,142800,710
943,10618,126,20000,21330,1330
944,10618,134,8440,9710,1270
945,10618,138,160810,161630,820
946,10618,158,117580,118710,1130
947,10618,159,10380,11610,1230
948,10618,168,121980,122650,670
949,10618,178,19290,20220,930
950,10618,185,156900,157870,970
951,10618,186,4690,5980,1290
952,10618,213,11240,12120,880
953,10618,217,91760,92590,830
954,10618,219,15910,16720,810
955,10618,222,93420,94350,930
956,10618,222,98690,99790,1100
957,10618,224,47540,50700,3160
958,10618,227,32460,33370,910
959,10618,230,18130,18860,730
960,10618,234,105280,106490,1210
961,10618,234,110280,111950,1670
962,10618,235,69260,71050,1790
963,10618,237,216410,217420,1010
964,10618,237,220840,221910,1070
965,10618,238,12350,13120,770
966,10618,251,67290,68130,840
967,10618,252,84850,85550,700
968,10618,253,22670,23820,1150
969,10618,273,305610,306560,950
970,10618,274,202770,203500,730
971,10618,275,40300,41550,1250
972,10618,276,13490,14190,700
973,10618,277,18330,19050,720
974,10618,282,199070,200120,1050
975,10618,283,46990,47840,850
976,10618,289,128360,129420,1060
977,10618,290,13880,15430,1550
978,10618,291,8860,9740,880
979,10618,301,139050,139760,710
980,10618,302,19050,20390,1340
981,10618,308,9610,12870,3260
982,10618,309,113560,114220,660
983,10618,312,14890,15920,1030
984,10618,324,148580,149340,760
985,10618,336,66890,67760,870
986,10618,337,120200,121080,880
987,10618,338,14860,15780,920
988,10618,349,81950,82740,790
989,10618,350,15070,15870,800
990,10618,353,18320,19360,1040
991,10618,357,21890,22990,1100
992,10618,360,15000,16290,1290
993,10618,373,8220,9040,820
994,10618,378,38660,46590,7930
995,10618,378,50590,51830,1240
996,10618,379,9950,10640,690
997,10618,384,188100,188990,890
998,10618,385,13340,14300,960
999,10618,387,99710,100460,750
1000,10618,389,9160,10430,1270
1001,10618,393,10330,11250,920
1002,10618,394,114010,114990,980
1003,10618,395,16840,19240,2400
1004,10618,401,157910,158720,810
1005,10618,402,42220,43270,1050
1006,10618,402,46830,50560,3730
1007,10618,403,24250,25500,1250
1008,10618,424,17230,18390,1160
1009,10618,425,78300,78830,530
1010,10618,429,5140,5660,520
1011,10618,439,27100,28330,1230
1012,10618,439,32810,34520,1710
1013,10618,441,150590,151320,730
1014,10618,445,14730,15690,960
1015,10618,448,61350,62710,1360
1016,10618,448,68290,69780,1490
1017,10618,449,12860,13940,1080
1018,10618,452,20250,21370,1120
1019,10618,456,15610,16530,920
1020,10618,458,99480,100510,1030
1021,10618,458,105310,106660,1350
1022,10618,459,18150,18970,820
1023,10618,462,23940,24780,840
1024,10618,466,19500,20270,770
1025,10618,471,83670,86000,2330
1026,10618,476,8790,10500,1710
1027,10618,480,69700,70400,700
1028,10618,481,188550,189300,750
1029,10618,482,18490,19820,1330
1030,10618,487,183670,184360,690
1031,10618,489,7420,8890,1470
1032,10618,492,103830,104700,870
1033,10618,493,17010,17890,880
1034,10618,493,133990,134890,900
1035,10618,493,139130,140240,1110
1036,10618,494,12620,13570,950
1037,10618,498,59200,60320,1120
1038,10618,500,9660,10520,860
1039,10618,504,87700,88310,610
1040,10618,509,13670,14680,1010
1041,10618,511,107300,108250,950
1042,10618,511,112560,113650,1090
1043,10618,512,28860,29760,900
1044,10618,514,153460,154340,880
1045,10618,519,198970,199610,640
1046,10618,522,99990,100660,670
1047,10618,525,11690,12660,970
1048,10618,526,88560,89490,930
1049,10618,535,14070,14910,840
1050,10618,565,22770,24690,1920
1051,10618,566,338070,338850,780
1052,10618,567,17360,18270,910
1053,10618,570,17300,17970,670
1054,10618,571,13450,14390,940
1055,10618,572,103610,104580,970
1056,10618,579,144600,145290,690
1057,10618,580,46660,47490,830
1058,10618,586,119220,119930,710
1059,10618,595,150760,151630,870
1060,10618,597,117820,118340,520
1061,10618,598,11650,12440,790
1062,10618,605,147090,148380,1290
1063,10618,607,141620,142430,810
1064,10618,608,9640,10770,1130
1065,10618,614,9600,10410,810
1066,10618,630,173210,174480,1270
1067,10618,634,15830,17650,1820
1068,10618,641,16760,17860,1100
1069,10618,650,21360,22660,1300
1070,10618,658,96340,97170,830
1071,10618,660,13350,14110,760
1072,10618,663,13060,14110,1050
1073,10618,666,53500,54900,1400
1074,10618,669,144400,145180,780
1075,10618,670,15950,16970,1020
1076,10618,673,33750,35140,1390
1077,10618,676,11560,12530,970
1078,10618,689,10800,11630,830
1079,10618,699,25580,28830,3250
1080,10618,702,29130,30070,940
1081,10618,713,529390,530250,860
1082,10618,714,29090,29850,760
1083,10618,716,21000,21930,930
1084,10618,721,141780,142540,760
1085,10618,722,12190,13220,1030
1086,10618,727,171610,172390,780
1087,10618,728,235960,237230,1270
1088,10618,735,200260,202920,2660
1089,10618,736,26730,27370,640
1090,10618,737,12320,13150,830
1091,10618,743,46870,48860,1990
1092,10618,754,38640,40330,1690
1093,10618,756,183860,184730,870
1094,10618,757,32880,33790,910
1095,10618,770,10370,13020,2650
1096,10618,776,13530,15080,1550
1097,10618,781,165600,166410,810
1098,10618,782,36420,39280,2860
1099,10618,788,111880,113790,1910
1100,10618,799,12930,13960,1030
1101,10618,801,163990,165090,1100
1102,10618,809,219560,221270,1710
1103,10618,816,116960,117710,750
1104,10618,819,126950,127710,760
1105,10618,820,19250,20010,760
1106,10618,840,188920,189540,620
1107,10618,848,125870,126680,810
1108,10618,849,13330,14670,1340
1109,10618,852,132670,133350,680
1110,10618,857,5840,6560,720
1111,10618,875,212480,213130,650
1112,10618,898,15000,15720,720
1113,10618,907,68990,74190,5200
1114,10618,907,78990,102970,23980
1115,10618,939,180190,180940,750
1116,10618,940,22980,23700,720
1117,10618,943,161860,162580,720
1118,10618,944,9790,10980,1190
1119,10618,946,119950,120630,680
1120,10618,947,11740,13850,2110
1121,10618,948,117760,118350,590
1122,10618,949,9150,10660,1510
1123,10618,952,10800,11710,910
1124,10618,979,213690,214360,670
1125,10618,980,11280,12110,830
1126,10618,991,10060,10700,640
1127,10618,999,12720,13490,770
1128,10618,1006,18030,19000,970
1129,10618,1014,184530,185130,600
1130,10618,1025,140890,144880,3990
1131,10618,1025,149160,152590,3430
1132,10618,1027,18410,19260,850
1133,10618,1036,106770,107500,730
1134,10618,1039,40960,42470,1510
1135,10618,1042,90070,90750,680
1136,10618,1043,16300,18960,2660
1137,10618,1049,145520,146140,620
1138,10618,1055,7450,8240,790
1139,10618,1059,59410,61590,2180
1140,10618,1068,7780,9080,1300
1141,10618,1079,71690,72320,630
1142,10618,1089,6660,7430,770
1143,10618,1093,32250,33030,780
1144,10618,1098,9230,11420,2190
1145,10618,1099,270980,271790,810
1146,10618,1100,16330,17410,1080
1147,10618,1118,23100,27290,4190
1148,10618,1128,9070,9920,850
1149,10618,1131,8750,9620,870
1150,10618,1135,6290,9180,2890
1151,10618,1147,225930,226580,650
1152,10618,1148,10700,11710,1010
1153,10618,1152,151450,152130,680
1154,10618,1164,144450,145280,830
1155,10618,1165,11170,11920,750
1156,10618,1173,38300,40810,2510
1157,10618,1176,49830,52070,2240
1158,10618,1188,63720,66350,2630
1159,10618,1189,232620,233470,850
1160,10618,1190,65220,66440,1220
1161,10618,1193,184990,185680,690
1162,10618,1194,5740,9310,3570
1163,10618,1202,96760,97570,810
1164,10618,1223,163030,163690,660
1165,10618,1230,156420,157080,660
1166,10618,1239,143090,143800,710
1167,10618,1240,9180,10400,1220
1168,10618,1253,12170,13490,1320
1169,10618,1257,7410,9120,1710
1170,10618,1267,6930,7810,880
1171,10618,1270,5790,6290,500
1172,10618,1271,18200,18910,710
1173,10618,1274,11150,12650,1500
1174,10618,1286,131040,131720,680
1175,10618,1289,11570,12470,900
1176,10618,1304,9730,10410,680
1177,10618,1305,103980,104660,680
1178,10618,1306,43520,44380,860
1179,10618,1314,9440,10170,730
1180,10618,1315,108800,109430,630
1181,10618,1316,9080,10390,1310
1182,10618,1319,118300,119010,710
1183,10618,1330,6970,8870,1900
1184,10618,1335,19250,20020,770
1185,10618,1338,111880,112560,680
1186,10618,1349,9400,10280,880
1187,10618,1356,136720,137490,770
1188,10618,1357,154120,159110,4990
1189,10618,1357,172110,173310,1200
1190,10618,1358,13580,14710,1130
1191,10618,1362,93810,94500,690
1192,10618,1363,23940,25800,1860
1193,10618,1374,142730,143530,800
1194,10618,1376,37090,37840,750
1195,10618,1380,74360,75200,840
1196,10618,1380,79410,80630,1220
1197,10618,1381,75990,77470,1480
1198,10618,1385,94470,95230,760
1199,10618,1388,10630,11600,970
1200,10618,1388,14400,15470,1070
1201,10618,1388,64090,64880,790
1202,10618,1395,8260,8960,700
1203,10618,1433,38300,39010,710
1204,10618,1434,8750,9460,710
1205,10618,1435,184490,185170,680
1206,10618,1436,11510,12860,1350
1207,10618,1470,169400,170210,810
1208,10618,1471,122100,131260,9160
1209,10618,1471,142110,143110,1000
1210,10618,1483,176870,177700,830
1211,10618,1484,52150,60000,7850
1212,10618,1485,207150,207860,710
1213,10618,1486,42470,43350,880
1214,10618,1488,158980,159770,790
1215,10618,1490,25200,26590,1390
1216,10618,1496,10820,11580,760
1217,10618,1505,9800,10560,760
1218,10618,1506,152890,154040,1150
1219,10618,1507,10220,11010,790
1220,10618,1520,9710,10720,1010
1221,10618,1521,141120,142090,970
1222,10618,1532,10970,11850,880
1223,10618,1549,132620,133360,740
1224,10618,1550,16240,17370,1130
1225,10618,1553,205910,206850,940
1226,10618,1554,39940,40740,800
1227,10618,1563,145010,150060,5050
1228,10618,1569,11310,12160,850
1229,10618,1575,104400,105120,720
1230,10618,1581,168060,168820,760
1231,10618,1582,9180,10000,820
1232,13101,1065,12880,14230,1350
1233,13101,1065,23810,24990,1180
1234,13101,1068,31250,32540,1290
1235,13101,1160,7940,9550,1610
1236,13101,13766,4480,5160,680
1237,13103,9590,120040,120980,940
1238,13103,9590,163250,164800,1550
1239,13103,10600,81620,82800,1180
1240,13105,11133,80590,81660,1070
1241,13105,14812,223680,241890,18210
1242,13105,14812,249000,250010,1010
1243,13105,14813,15520,17780,2260
1244,13105,14919,28880,30110,1230
1245,13105,15272,71080,72180,1100
1246,13105,17511,33860,34890,1030
1247,13105,20028,12840,14090,1250
1248,13106,18025,27740,29050,1310
1249,13106,18025,38860,39950,1090
1250,13107,164,60110,61130,1020
1251,13107,165,18760,19780,1020
1252,13107,321,32060,33060,1000
1253,13107,322,17210,18200,990
1254,13107,434,33420,34350,930
1255,13107,679,57940,58970,1030
1256,13107,3270,102850,104080,1230
1257,13107,3356,7420,8770,1350
1258,13107,3727,27830,28580,750
1259,13107,3778,30340,31170,830
1260,13107,3835,33040,33900,860
1261,13107,3836,8340,9570,1230
1262,13107,3972,55170,55990,820
1263,13107,4135,33820,34770,950
1264,13107,4195,40570,41390,820
1265,13107,4278,37580,38480,900
1266,13107,4351,31120,31910,790
1267,13107,4458,30630,31510,880
1268,13107,4459,11560,14550,2990
1269,13107,4584,18730,19750,1020
1270,13107,4652,7020,7870,850
1271,13107,4728,26490,27380,890
1272,13107,4838,62460,63260,800
1273,13107,4839,12680,13630,950
1274,13107,5214,36270,37170,900
1275,13107,5215,9460,10560,1100
1276,13107,5261,44750,45610,860
1277,13107,5262,7110,8070,960
1278,13107,5309,38610,39450,840
1279,13107,5310,7880,8890,1010
1280,13107,5319,12320,13730,1410
1281,13107,5395,37510,38460,950
1282,13107,5516,101620,102400,780
1283,13107,5590,107750,108550,800
1284,13107,5591,7170,8060,890
1285,13107,5623,47910,48820,910
1286,13107,5701,41170,41920,750
1287,13107,5702,8930,9890,960
1288,13107,5824,103280,104030,750
1289,13107,5921,98620,99350,730
1290,13107,6037,23830,24650,820
1291,13107,6263,42550,43580,1030
1292,13107,6376,53630,54550,920
1293,13107,6377,15080,17750,2670
1294,13107,6490,36050,37020,970
1295,13107,6589,44370,45110,740
1296,13107,6632,46690,47570,880
1297,13107,6710,43480,44390,910
1298,13107,6922,43890,45880,1990
1299,13107,6967,51940,52810,870
1300,13107,6968,19950,21790,1840
1301,13107,7045,51120,52410,1290
1302,13107,7059,52800,53660,860
1303,13107,7170,32120,32890,770
1304,13107,7502,117820,119100,1280
1305,13107,7544,84040,85450,1410
1306,13107,7764,41280,42540,1260
1307,13107,7802,66110,67580,1470
1308,13107,7952,360,1490,1130
1309,13107,7953,7740,8750,1010
1310,13107,8007,44900,45980,1080
1311,13107,8008,3330,5010,1680
1312,13107,8115,70650,72030,1380
1313,13107,8130,48150,49710,1560
1314,13107,9357,204220,205520,1300
1315,13107,9425,85210,86640,1430
1316,13107,9505,57730,59080,1350
1317,13107,9608,251110,252160,1050
1318,13107,9692,50720,51990,1270
1319,13107,9771,52280,53470,1190
1320,13107,9851,50820,52160,1340
1321,13107,9928,56770,58280,1510
1322,13107,9992,45230,46860,1630
1323,13107,10056,6780,8010,1230
1324,13107,10091,36160,37550,1390
1325,13107,10155,7500,8670,1170
1326,13107,10185,40580,41930,1350
1327,13107,10276,81660,82940,1280
1328,13107,10367,115430,116730,1300
1329,13107,10441,41810,43260,1450
1330,13107,10511,64460,65340,880
1331,13107,10541,45090,46370,1280
1332,13107,10552,38910,40230,1320
1333,13107,10584,5580,7360,1780
1334,13107,10611,42360,43780,1420
1335,13107,10829,41300,42650,1350
1336,13107,10935,28460,30000,1540
1337,13107,11030,46650,48180,1530
1338,13107,11128,43910,45070,1160
1339,13107,11292,9040,9580,540
1340,13107,11329,26360,27910,1550
1341,13107,11391,19280,19350,70
1342,13107,11426,39790,41040,1250
1343,13107,11651,62520,63960,1440
1344,13107,11766,33990,35140,1150
1345,13107,11862,31900,33210,1310
1346,13107,12030,9530,10700,1170
1347,13107,12049,66790,68220,1430
1348,13107,12067,202040,203400,1360
1349,13107,12093,32670,34160,1490
1350,13107,12134,4350,6390,2040
1351,13107,12175,33290,34690,1400
1352,13107,12250,4230,6050,1820
1353,13107,12266,76490,77810,1320
1354,13107,12297,32750,34380,1630
1355,13107,12416,92310,93620,1310
1356,13107,12525,39590,40740,1150
1357,13107,12550,35500,36710,1210
1358,13107,12661,40130,41360,1230
1359,13107,16011,30400,31370,970
1360,13108,798,81620,82700,1080
1361,13108,1260,43690,45600,1910
1362,13108,7676,95480,96940,1460
1363,13108,8094,2670,4300,1630
1364,13108,8567,173870,174770,900
1365,13108,10135,6060,8730,2670
1366,13108,10490,62290,63850,1560
1367,13109,4471,46280,47280,1000
1368,13109,8660,870,2500,1630
1369,13109,10226,61960,62870,910
1370,13109,10226,80300,81310,1010
1371,13109,10921,12140,13280,1140
1372,13109,11995,15880,16960,1080
1373,13109,12116,25520,26800,1280
1374,13109,12219,20120,21330,1210
1375,13109,12325,15110,16240,1130
1376,13109,12439,18920,19990,1070
1377,13109,12440,10340,11950,1610
1378,13109,12577,18560,19880,1320
1379,13109,12807,17610,18820,1210
1380,13109,12952,11730,13420,1690
1381,13109,12953,7620,7770,150
1382,13109,13044,17560,19160,1600
1383,13109,13045,8950,8960,10
1384,13109,13518,47590,48380,790
1385,13109,13854,43620,44990,1370
1386,13109,13984,7420,7730,310
1387,13109,14112,15330,17420,2090
1388,13109,14230,28580,29870,1290
1389,13109,14573,67580,68970,1390
1390,13109,14678,31630,32760,1130
1391,13109,14801,56670,58400,1730
1392,13109,14889,40400,41670,1270
1393,13109,14890,11280,11410,130
1394,13110,1367,18740,20040,1300
1395,13110,1370,2240,3460,1220
1396,13110,4709,38640,39970,1330
1397,13110,4709,67350,68530,1180
1398,15901,1,61880,62650,770
1399,17101,238,73560,78290,4730
1400,17101,239,200,3720,3520
1401,17101,480,46210,49310,3100
1402,17101,481,200,1210,1010
1403,17101,609,97880,99880,2000
1404,17101,733,262610,263560,950
1405,17101,733,437210,438400,1190
1406,17101,866,801520,803530,2010
1407,17101,1052,213540,214640,1100
1408,17101,1052,360650,361740,1090
1409,17101,1167,118050,119060,1010
1410,17101,1175,87870,91380,3510
1411,17101,1182,93370,94130,760
1412,17101,1201,102830,103890,1060
1413,17101,1213,83660,84750,1090
1414,17101,1213,242390,242990,600
1415,17101,1220,87410,89230,1820
1416,17101,1228,96660,97730,1070
1417,17101,1236,102200,103220,1020
1418,17101,1236,243620,248500,4880
1419,17101,1455,231280,231950,670
1420,17101,1455,264090,264980,890
1421,17101,1498,1659370,1660180,810
1422,17101,2144,115010,115690,680
1423,17101,2144,271210,271810,600
1424,17101,2144,290800,292180,1380
1425,17101,2144,429870,430510,640
1426,17101,2144,472850,473490,640
1427,17101,2144,618030,618660,630
1428,17101,2144,650370,651340,970
1429,17101,2144,791720,792360,640
1430,17101,2144,829380,830070,690
1431,17101,2144,967390,968020,630
1432,17101,2144,1100490,1102410,1920
1433,17101,2144,1256180,1256840,660
1434,17101,2144,1277500,1278400,900
1435,17101,2144,1426810,1427580,770
1436,17101,2145,1461090,1461820,730
1437,17101,2145,1608330,1608950,620
1438,17101,2145,1639430,1640130,700
1439,17102,929,65650,66790,1140
1440,17102,929,126140,126800,660
1441,17102,929,192710,193660,950
1442,17102,929,331810,332440,630
1443,17102,929,373470,374290,820
1444,17102,929,501900,502450,550
1445,17102,929,551600,552510,910
1446,17102,929,689690,690290,600
1447,17102,929,739300,740250,950
1448,17102,929,865690,866300,610
1449,17102,929,915530,916240,710
1450,17102,929,1042070,1042800,730
1451,17102,1576,100780,101320,540
1452,17102,1576,106930,109860,2930
1453,17102,1576,250010,250590,580
1454,17102,1576,260650,261610,960
1455,17102,1576,413350,414060,710
1456,17102,1576,433970,434990,1020
1457,17102,1576,587640,588230,590
1458,17102,1576,614510,616560,2050
1459,17102,1576,763710,764350,640
1460,17102,1576,795080,796050,970
1461,17102,1607,82070,83090,1020
1462,17102,1607,263950,265030,1080
1463,17102,1607,438090,439440,1350
1464,17102,1607,642280,643190,910
1465,17102,1607,832380,833270,890
1466,17102,1607,1016360,1017030,670
1467,17102,1669,212640,213520,880
1468,17102,1669,379040,379610,570
1469,17102,1669,398450,399280,830
1470,17102,1669,545170,545800,630
1471,17102,1669,576600,578210,1610
1472,17102,1669,716040,716580,540
1473,17102,1669,752220,753340,1120
1474,17102,1669,932130,933000,870
1475,17102,1669,1118390,1119160,770
1476,17103,849,207460,208360,900
