Event,Device,Trip,Starttime,Endtime,Duration
1,92,35,410,410,0
2,92,43,12450,13510,1060
3,501,8,81990,82950,960
4,501,39,201500,202240,740
5,501,43,14550,15190,640
6,501,56,114320,115010,690
7,501,222,4190,4280,90
8,502,11,163900,164720,820
9,502,24,109830,110660,830
10,502,29,117670,118500,830
11,502,46,104310,105340,1030
12,502,52,112510,113670,1160
13,502,58,108470,109460,990
14,502,73,91650,92780,1130
15,502,80,106350,107210,860
16,502,112,92120,92870,750
17,502,123,95350,96060,710
18,502,130,119230,120160,930
19,502,137,117460,118450,990
20,502,142,93990,96580,2590
21,502,154,99090,100040,950
22,502,159,127170,128520,1350
23,502,179,97510,98180,670
24,502,184,19280,20170,890
25,502,243,102670,103240,570
26,502,248,86010,86760,750
27,502,261,80360,81540,1180
28,502,279,62020,62980,960
29,502,285,99340,100080,740
30,502,293,110760,111460,700
31,502,299,108990,109620,630
32,502,322,171000,172240,1240
33,502,328,103300,104540,1240
34,502,332,110920,111890,970
35,502,661,42290,43480,1190
36,551,69,92350,93520,1170
37,551,561,26060,27040,980
38,551,579,22450,23110,660
39,551,585,90990,91770,780
40,551,765,380,390,10
41,551,824,330,810,480
42,552,340,119050,121380,2330
43,552,356,10910,11910,1000
44,552,360,111520,113980,2460
45,552,374,142170,144290,2120
46,552,380,152570,154360,1790
47,552,382,164040,165800,1760
48,3268,43,475740,476810,1070
49,3268,79,70110,71100,990
50,10107,76,250200,250580,380
51,10120,285,127570,128940,1370
52,10120,397,20610,24010,3400
53,10120,398,870,1400,530
54,10122,16,305920,310550,4630
55,10122,155,144760,145450,690
56,10122,162,135800,136410,610
57,10122,202,141500,149290,7790
58,10122,206,198860,199390,530
59,10122,206,204080,204630,550
60,10122,240,360800,361450,650
61,10122,242,157450,158070,620
62,10122,251,161220,161810,590
63,10122,253,194020,194650,630
64,10122,255,171000,171570,570
65,10122,257,167730,168340,610
66,10122,260,151540,152110,570
67,10122,272,146710,147280,570
68,10122,274,150320,150930,610
69,10122,276,147570,148100,530
70,10122,278,201980,202730,750
71,10122,285,134320,134990,670
72,10122,286,9600,10230,630
73,10122,287,213670,214460,790
74,10122,287,215650,215680,30
75,10122,289,15790,22470,6680
76,10122,289,33580,34430,850
77,10122,291,480270,485500,5230
78,10122,291,489270,489940,670
79,10122,292,41540,53560,12020
80,10122,292,240600,241250,650
81,10122,295,149140,149770,630
82,10122,301,139560,140210,650
83,10122,305,160120,160830,710
84,10122,308,147800,148430,630
85,10122,312,140880,144310,3430
86,10122,317,148080,148690,610
87,10122,318,4590,5140,550
88,10122,331,90360,90970,610
89,10122,334,182070,182730,660
90,10122,335,2580,3180,600
91,10122,337,220880,221790,910
92,10122,339,480330,480760,430
93,10122,340,810,2180,1370
94,10122,341,142810,143420,610
95,10122,342,1600,2230,630
96,10122,347,168010,169530,1520
97,10122,348,290,780,490
98,10122,351,153050,154390,1340
99,10122,352,2820,3430,610
100,10122,354,173170,174130,960
101,10122,357,135800,136340,540
102,10122,358,1260,1490,230
103,10122,368,142080,142690,610
104,10122,369,4320,4830,510
105,10122,370,160820,161430,610
106,10122,371,5950,6600,650
107,10122,375,154250,154860,610
108,10122,376,16750,17230,480
109,10122,381,108260,108840,580
110,10122,382,9850,10430,580
111,10122,386,131970,132550,580
112,10122,387,6090,6690,600
113,10122,398,148540,149100,560
114,10122,399,14090,14570,480
115,10122,403,158050,158870,820
116,10122,404,6320,6850,530
117,10122,406,138700,139320,620
118,10122,407,4710,5200,490
119,10122,409,135150,135780,630
120,10122,410,210,680,470
121,10122,413,154060,154860,800
122,10122,414,2410,2970,560
123,10122,415,143850,144290,440
124,10122,416,4410,4940,530
125,10122,425,154680,155350,670
126,10122,426,4000,4270,270
127,10122,427,154380,154960,580
128,10122,428,1300,1700,400
129,10122,430,181460,182090,630
130,10122,431,2620,3160,540
131,10122,432,173070,173670,600
132,10122,433,3040,3580,540
133,10122,437,23850,24440,590
134,10122,438,1890,3160,1270
135,10122,446,195350,196110,760
136,10122,447,8430,8960,530
137,10122,448,166150,166760,610
138,10122,449,5060,5470,410
139,10122,453,155160,155620,460
140,10122,454,8420,8930,510
141,10122,456,82900,83460,560
142,10122,457,1580,2210,630
143,10122,459,146940,148360,1420
144,10122,468,8510,9260,750
145,10122,469,1960,3910,1950
146,10122,471,30290,30860,570
147,10122,472,3440,3930,490
148,10122,473,164240,164890,650
149,10122,474,3390,3820,430
150,10122,475,180380,180920,540
151,10122,476,5960,6440,480
152,10122,478,138700,139300,600
153,10122,479,8410,8830,420
154,10122,489,165420,166110,690
155,10122,490,3400,4060,660
156,10122,492,165080,165660,580
157,10122,492,171090,171620,530
158,10122,495,70960,71540,580
159,10122,496,1990,4810,2820
160,10122,499,142510,143120,610
161,10122,500,2490,2930,440
162,10122,505,137620,138170,550
163,10122,506,9180,9660,480
164,10122,508,141020,141630,610
165,10122,509,4920,5440,520
166,10122,514,165120,165680,560
167,10122,515,1910,2620,710
168,10122,518,151880,152440,560
169,10122,518,158520,159090,570
170,10122,523,157250,157860,610
171,10122,530,211890,212480,590
172,10122,531,5040,5510,470
173,10122,544,144810,145380,570
174,10122,545,3660,4220,560
175,10122,548,161640,162170,530
176,10122,549,5470,5970,500
177,10122,550,129520,130150,630
178,10122,551,2660,4020,1360
179,10122,555,59870,60460,590
180,10122,555,66950,67580,630
181,10122,560,2220,2890,670
182,10122,565,148480,149370,890
183,10122,566,7910,8530,620
184,10122,575,13740,14330,590
185,10122,576,1840,2370,530
186,10122,577,151130,151750,620
187,10122,578,2680,3340,660
188,10122,579,188350,189090,740
189,10122,586,13700,14260,560
190,10122,589,123310,124370,1060
191,10122,601,169060,169850,790
192,10122,602,8570,9210,640
193,10122,603,159160,159780,620
194,10122,604,7130,7630,500
195,10122,607,160700,161250,550
196,10122,608,2670,3420,750
197,10122,612,163330,164180,850
198,10122,613,6090,6540,450
199,10122,622,157950,158650,700
200,10122,623,1780,2560,780
201,10122,633,165050,165720,670
202,10122,634,7050,7580,530
203,10122,640,147010,147580,570
204,10122,641,2230,2930,700
205,10122,643,187670,188250,580
206,10122,644,1770,2350,580
207,10122,646,6290,7110,820
208,10122,648,158980,159690,710
209,10122,649,2930,3600,670
210,10122,650,152960,154310,1350
211,10122,651,4650,5220,570
212,10122,652,157340,158010,670
213,10122,653,5040,5780,740
214,10122,655,153930,154650,720
215,10122,659,163310,163800,490
216,10122,660,2040,2780,740
217,10122,662,155480,156160,680
218,10122,665,143780,144500,720
219,10122,666,1170,8260,7090
220,10122,668,7380,8310,930
221,10122,669,1730,2440,710
222,10122,670,143080,143720,640
223,10122,671,820,1530,710
224,10122,673,146060,146950,890
225,10122,675,29550,30080,530
226,10122,676,1260,1750,490
227,10122,679,25950,26400,450
228,10122,680,3470,4090,620
229,10122,682,27910,28360,450
230,10122,683,2660,3270,610
231,10122,687,3150,3690,540
232,10122,688,143230,143700,470
233,10122,694,144520,145030,510
234,10122,695,890,1340,450
235,10122,698,129460,130190,730
236,10122,699,1760,2370,610
237,10122,701,14900,15430,530
238,10122,702,1070,1800,730
239,10122,704,151570,152230,660
240,10122,705,4950,5540,590
241,10122,723,182920,183410,490
242,10122,737,135620,136110,490
243,10122,738,6020,6720,700
244,10122,741,161540,162090,550
245,10122,742,2340,7420,5080
246,10122,744,11120,11610,490
247,10122,744,15710,16240,530
248,10122,746,146830,147480,650
249,10122,747,1550,3240,1690
250,10122,755,144750,145440,690
251,10122,756,4380,4910,530
252,10122,757,154290,154900,610
253,10122,758,2490,3210,720
254,10122,760,147970,148570,600
255,10122,761,620,1220,600
256,10122,764,148610,151030,2420
257,10122,765,2220,2460,240
258,10122,766,151290,151980,690
259,10122,767,510,1220,710
260,10122,768,152370,152970,600
261,10122,769,3390,3940,550
262,10122,770,128510,129060,550
263,10122,771,1300,2530,1230
264,10122,775,137370,137940,570
265,10122,776,3760,4210,450
266,10122,778,151650,152320,670
267,10122,779,2180,2700,520
268,10122,797,159730,160290,560
269,10122,798,1330,1750,420
270,10122,801,171170,171680,510
271,10122,802,8640,9180,540
272,10122,803,140280,140850,570
273,10122,804,4400,5030,630
274,10122,808,153480,153990,510
275,10122,809,1120,1750,630
276,10122,810,139050,139530,480
277,10122,811,2680,3160,480
278,10122,816,136620,137150,530
279,10122,817,1170,1750,580
280,10122,819,250610,251170,560
281,10122,819,257570,258080,510
282,10122,821,159160,159700,540
283,10122,822,3060,3570,510
284,10122,827,174500,175010,510
285,10122,828,2190,2710,520
286,10122,829,195630,196140,510
287,10122,830,1380,1920,540
288,10122,832,153140,153740,600
289,10122,833,3400,4080,680
290,10122,845,181040,181610,570
291,10122,846,5430,6130,700
292,10122,849,168870,169530,660
293,10122,850,2430,3030,600
294,10122,855,142160,142780,620
295,10122,856,5490,5940,450
296,10122,859,154320,154890,570
297,10122,860,2610,2990,380
298,10122,861,183680,184350,670
299,10122,862,3810,5060,1250
300,10122,865,161910,162520,610
301,10122,866,3270,3730,460
302,10122,871,54820,55450,630
303,10122,871,61080,61610,530
304,10122,872,2590,3240,650
305,10122,873,2330,2900,570
306,10122,877,149600,150370,770
307,10122,878,8950,9560,610
308,10122,887,159520,160150,630
309,10122,888,2080,2690,610
310,10122,893,6720,7460,740
311,10122,894,152570,153210,640
312,10122,895,3910,4650,740
313,10122,897,162250,162840,590
314,10122,898,2530,3350,820
315,10122,899,141300,141920,620
316,10122,899,147720,148280,560
317,10122,901,52750,53260,510
318,10122,902,2140,2880,740
319,10122,909,155970,156770,800
320,10122,909,161370,162670,1300
321,10122,912,158380,159000,620
322,10122,913,5090,5790,700
323,10122,915,164500,165970,1470
324,10122,915,171350,171850,500
325,10122,919,151170,151880,710
326,10122,922,47080,47760,680
327,10122,924,19460,20040,580
328,10122,935,215590,216120,530
329,10122,936,5800,6380,580
330,10122,937,176270,176830,560
331,10122,938,8120,8690,570
332,10122,945,156600,157220,620
333,10122,946,4720,5220,500
334,10122,947,146640,147200,560
335,10122,961,157410,158460,1050
336,10122,962,2170,2670,500
337,10122,965,154860,155450,590
338,10122,966,2710,3290,580
339,10122,967,149600,150190,590
340,10122,968,1840,2500,660
341,10122,971,115830,116640,810
342,10122,972,200,920,720
343,10122,976,144630,145140,510
344,10122,977,4410,4880,470
345,10122,983,192570,193020,450
346,10122,983,201170,201830,660
347,10122,985,158710,159400,690
348,10122,988,5390,6130,740
349,10122,989,157700,158270,570
350,10122,990,1120,2570,1450
351,10122,995,154850,155340,490
352,10122,995,159210,159690,480
353,10122,997,131150,131720,570
354,10122,998,1160,1490,330
355,10122,999,42880,43530,650
356,10122,1000,2240,2760,520
357,10122,1004,151860,152470,610
358,10122,1005,1320,1800,480
359,10122,1006,150470,152040,1570
360,10122,1007,3940,4450,510
361,10122,1011,147730,148330,600
362,10122,1011,154520,155130,610
363,10122,1020,180770,181360,590
364,10122,1021,1500,1540,40
365,10122,1023,148450,149040,590
366,10122,1024,3360,4090,730
367,10122,1032,178790,179380,590
368,10122,1033,2370,2980,610
369,10122,1034,174660,175330,670
370,10122,1036,132090,132690,600
371,10122,1037,3150,3710,560
372,10122,1040,185260,185930,670
373,10122,1041,1120,1620,500
374,10122,1043,159160,159810,650
375,10122,1044,2980,3470,490
376,10122,1046,7420,7900,480
377,10122,1046,16080,16670,590
378,10122,1048,134470,134990,520
379,10122,1049,2160,2680,520
380,10122,1060,148900,151850,2950
381,10122,1061,1640,2000,360
382,10122,1062,42560,42940,380
383,10122,1063,2080,2510,430
384,10122,1065,16170,16600,430
385,10122,1066,4020,4620,600
386,10122,1067,148420,149040,620
387,10122,1068,5880,6470,590
388,10122,1069,150000,150610,610
389,10122,1070,2100,2520,420
390,10122,1071,138420,138990,570
391,10122,1072,4220,4730,510
392,10122,1073,148600,149180,580
393,10122,1074,4450,5370,920
394,10122,1075,151220,152240,1020
395,10122,1076,6450,7160,710
396,10122,1077,162600,164440,1840
397,10122,1078,1860,2500,640
398,10122,1085,142030,142690,660
399,10122,1086,2870,4190,1320
400,10122,1088,12650,13060,410
401,10122,1089,3680,4230,550
402,10122,1091,148290,148840,550
403,10122,1092,3430,4150,720
404,10122,1094,147800,148720,920
405,10122,1095,3440,3980,540
406,10122,1096,146030,146740,710
407,10122,1097,2660,3140,480
408,10122,1115,163790,164470,680
409,10122,1116,3760,4450,690
410,10122,1118,204880,205590,710
411,10122,1119,2470,3930,1460
412,10122,1120,183600,184310,710
413,10122,1120,190370,190800,430
414,10122,1123,77190,77600,410
415,10122,1123,85530,86140,610
416,10122,1126,49080,49470,390
417,10122,1126,52880,53460,580
418,10122,1129,144760,145390,630
419,10122,1130,2160,2840,680
420,10122,1136,153000,153560,560
421,10122,1136,159210,159700,490
422,10122,1138,185950,187370,1420
423,10122,1139,200,700,500
424,10122,1142,176680,177810,1130
425,10122,1143,6180,6730,550
426,10122,1224,145640,146870,1230
427,10122,1225,2130,2580,450
428,10122,1228,151920,152530,610
429,10122,1229,200,680,480
430,10122,1234,167620,168420,800
431,10122,1239,130350,130970,620
432,10122,1240,1670,2190,520
433,10122,1263,133570,136160,2590
434,10122,1287,124000,124700,700
435,10122,1295,196270,197060,790
436,10122,1296,3410,4140,730
437,10122,1297,52830,53390,560
438,10122,1298,1660,2410,750
439,10122,1304,250180,250880,700
440,10122,1305,1740,2390,650
441,10122,1312,146190,146810,620
442,10122,1312,152570,153100,530
443,10122,1315,179640,180300,660
444,10122,1316,5490,6070,580
445,10122,1318,168960,169860,900
446,10122,1319,3710,4310,600
447,10122,1322,167680,168290,610
448,10122,1323,14200,14950,750
449,10122,1325,254460,255060,600
450,10122,1326,6800,7470,670
451,10122,1329,168400,169090,690
452,10122,1330,290,1580,1290
453,10122,1337,152010,152640,630
454,10122,1338,10300,10750,450
455,10122,1339,206550,207240,690
456,10122,1340,1160,1860,700
457,10122,1341,145660,146220,560
458,10122,1342,18220,18830,610
459,10122,1343,429970,430710,740
460,10122,1344,4600,5120,520
461,10122,1345,143840,144440,600
462,10122,1346,4060,4620,560
463,10122,1354,420480,421620,1140
464,10122,1355,11230,11950,720
465,10122,1356,170360,171020,660
466,10122,1357,3990,4580,590
467,10122,1359,201120,202240,1120
468,10122,1359,208550,209140,590
469,10122,1361,171800,172650,850
470,10122,1362,4550,5090,540
471,10122,1365,47810,48380,570
472,10122,1366,1380,2100,720
473,10122,1373,133150,133660,510
474,10122,1373,142560,143270,710
475,10122,1379,508220,509000,780
476,10122,1379,517000,517830,830
477,10122,1381,466410,479550,13140
478,10122,1382,1080,1910,830
479,10122,1384,157330,157960,630
480,10122,1385,6370,7030,660
481,10122,1395,160440,161850,1410
482,10122,1396,2640,3200,560
483,10122,1397,33710,34210,500
484,10122,1397,44820,45570,750
485,10122,1402,157790,158470,680
486,10122,1403,6280,6950,670
487,10122,1408,152470,153160,690
488,10122,1409,5940,6610,670
489,10122,1410,163640,164320,680
490,10122,1411,1620,2190,570
491,10122,1412,153990,154850,860
492,10122,1413,11040,11540,500
493,10122,1427,148330,149050,720
494,10122,1428,2030,2650,620
495,10122,1430,196700,199040,2340
496,10122,1431,12810,13520,710
497,10122,1433,144410,145750,1340
498,10122,1434,2050,2750,700
499,10122,1437,174260,175890,1630
500,10122,1438,4240,4960,720
501,10122,1439,158830,159590,760
502,10122,1440,210,640,430
503,10122,1460,181560,182160,600
504,10122,1461,2400,3020,620
505,10122,1463,183460,184080,620
506,10122,1464,2570,3210,640
507,10125,715,4110,4130,20
508,10129,414,27300,29100,1800
509,10129,2497,1800,1840,40
510,10130,1242,6910,8150,1240
511,10130,1243,15240,16420,1180
512,10133,97,7730,8740,1010
513,10134,401,15570,15570,0
514,10137,4,680,1240,560
515,10137,1247,4300,4530,230
516,10138,309,4370,5100,730
517,10138,3112,5040,5110,70
518,10138,3130,2260,2390,130
519,10138,3333,2520,2650,130
520,10139,782,71680,74190,2510
521,10139,832,82750,83520,770
522,10139,5014,61310,65660,4350
523,10139,5018,92320,96180,3860
524,10139,5020,66230,69050,2820
525,10139,7138,90720,93670,2950
526,10140,1025,7180,7730,550
527,10140,1026,200,480,280
528,10141,13,163340,163810,470
529,10141,554,10540,10830,290
530,10141,601,62760,63210,450
531,10141,748,185300,185760,460
532,10141,748,189670,191770,2100
533,10145,1571,5760,5760,0
534,10150,292,83680,84410,730
535,10150,366,82270,82740,470
536,10150,366,87830,88740,910
537,10150,403,32590,33100,510
538,10150,430,40790,41180,390
539,10150,518,111570,111980,410
540,10150,520,6970,7470,500
541,10150,769,199660,215470,15810
542,10150,781,191900,202740,10840
543,10150,1952,28410,28870,460
544,10150,2300,22230,24930,2700
545,10150,2784,190,3550,3360
546,10150,3024,2550,3650,1100
547,10150,3087,116810,118080,1270
548,10150,3088,1240,1910,670
549,10150,3145,6870,8030,1160
550,10150,3973,1510,2380,870
551,10150,3985,1220,2910,1690
552,10150,4039,16090,18060,1970
553,10150,4067,52070,53190,1120
554,10150,4158,2740,2740,0
555,10150,5473,14250,22700,8450
556,10150,5473,25110,26610,1500
557,10150,5671,31290,31300,10
558,10155,633,69220,70220,1000
559,10155,659,55710,57510,1800
560,10155,1051,45170,46120,950
561,10155,1148,11620,12860,1240
562,10160,710,117420,117910,490
563,10160,710,124690,126130,1440
564,10160,711,2610,3960,1350
565,10160,716,163180,163700,520
566,10160,3365,340,470,130
567,10160,3678,1150,4840,3690
568,10161,989,40590,41790,1200
569,10161,2166,70840,74410,3570
570,10161,2167,9980,45820,35840
571,10161,2168,45950,52420,6470
572,10161,2184,91230,91740,510
573,10161,2185,210,390,180
574,10164,186,53060,53520,460
575,10164,186,56150,60680,4530
576,10164,187,960,1520,560
577,10164,931,53490,55660,2170
578,10164,1162,53980,55480,1500
579,10164,1225,54540,56270,1730
580,10164,2147,66960,68440,1480
581,10165,184,74440,74480,40
582,10165,908,77740,85400,7660
583,10165,914,134900,155660,20760
584,10165,930,68160,83190,15030
585,10165,930,87160,92110,4950
586,10165,930,96600,111330,14730
587,10165,963,59440,74810,15370
588,10165,966,120930,125030,4100
589,10165,982,90090,91510,1420
590,10165,983,96300,100660,4360
591,10165,983,101860,104540,2680
592,10165,983,168980,178140,9160
593,10165,983,182970,196620,13650
594,10165,983,197890,199730,1840
595,10165,985,91350,100850,9500
596,10165,1047,96350,112180,15830
597,10165,1073,3650,3870,220
598,10165,1073,6040,6040,0
599,10165,1145,90870,99010,8140
600,10165,1239,112220,129490,17270
601,10165,1239,130840,135140,4300
602,10165,1245,8780,11580,2800
603,10165,1245,12810,17810,5000
604,10165,1351,101590,117360,15770
605,10165,1382,88250,89340,1090
606,10165,1411,4430,5520,1090
607,10165,1427,159310,172180,12870
608,10165,1429,96520,101110,4590
609,10165,1433,6100,7230,1130
610,10165,1449,121780,137800,16020
611,10165,1468,185150,186560,1410
612,10165,1472,84700,86120,1420
613,10165,1473,171370,181660,10290
614,10165,1477,81810,82940,1130
615,10165,1479,122070,123380,1310
616,10165,1484,92640,93770,1130
617,10165,1491,161370,162530,1160
618,10165,1536,87950,89080,1130
619,10165,1540,282590,299470,16880
620,10165,1547,301080,302320,1240
621,10165,1548,198770,200090,1320
622,10165,1558,122250,134510,12260
623,10165,1564,133400,144890,11490
624,10165,1591,2720,3470,750
625,10173,1254,820,1070,250
626,10176,2175,12210,12210,0
627,10176,3329,25730,26080,350
628,10176,3846,15990,17150,1160
629,10204,246,1430,3030,1600
630,10204,324,5640,5860,220
631,10204,335,64030,65240,1210
632,10204,469,53620,54550,930
633,10204,586,360,840,480
634,10204,1525,271360,274340,2980
635,10204,1530,38660,39320,660
636,10204,1530,51180,51710,530
637,10204,1530,53820,76940,23120
638,10204,1615,7760,13050,5290
639,10204,1615,36430,36830,400
640,10204,1615,46040,47770,1730
641,10204,1615,132710,133160,450
642,10204,3079,24720,26050,1330
643,10204,3079,35340,36610,1270
644,10204,3079,50380,51730,1350
645,10204,3079,61120,62330,1210
646,10204,3079,72460,73770,1310
647,10204,3079,87280,88530,1250
648,10204,3079,138780,140050,1270
649,10204,3086,4900,6270,1370
650,10204,3168,77900,78990,1090
651,10204,3169,37310,39080,1770
652,10204,3174,143340,144770,1430
653,10204,3174,215820,217430,1610
654,10204,3174,276020,277530,1510
655,10204,3176,10870,12500,1630
656,10204,3179,82070,83600,1530
657,10204,3179,153270,154780,1510
658,10204,3179,213210,214760,1550
659,10204,3179,266710,268220,1510
660,10204,3181,22850,24340,1490
661,10204,3181,77590,79100,1510
662,10204,3182,77030,78380,1350
663,10204,3182,147750,149320,1570
664,10204,3182,206610,207960,1350
665,10204,3184,37710,39360,1650
666,10204,3184,93450,94820,1370
667,10204,3187,72500,73970,1470
668,10204,3187,131480,132810,1330
669,10204,3187,188900,190410,1510
670,10204,3189,119530,120860,1330
671,10204,3189,179390,180780,1390
672,10204,3190,21950,23720,1770
673,10204,3190,83410,85060,1650
674,10204,3190,144610,146340,1730
675,10204,3190,197130,198760,1630
676,10204,3192,26750,28320,1570
677,10204,3194,38030,39680,1650
678,10204,3200,18430,19680,1250
679,10204,3201,3390,4620,1230
680,10204,3202,16680,18470,1790
681,10204,3202,84010,85680,1670
682,10204,3202,141990,143500,1510
683,10204,3203,10200,11650,1450
684,10204,3205,23180,25230,2050
685,10204,3205,76020,77610,1590
686,10204,3206,63760,65130,1370
687,10204,3206,124260,126010,1750
688,10204,3206,203060,204590,1530
689,10204,3209,34410,36120,1710
690,10204,3209,89970,91460,1490
691,10204,3233,49040,50490,1450
692,10204,3233,120860,122470,1610
693,10204,3233,182300,183950,1650
694,10204,3233,259280,260830,1550
695,10204,3234,21620,23130,1510
696,10204,3234,69860,71750,1890
697,10204,3235,16220,17810,1590
698,10204,3235,85560,86830,1270
699,10204,3235,144640,146090,1450
700,10204,3235,222100,223530,1430
701,10204,3236,32080,33270,1190
702,10204,3237,55360,56530,1170
703,10204,3238,72740,73850,1110
704,10205,254,61390,62320,930
705,10205,358,210,240,30
706,10205,452,210,260,50
707,10205,673,2520,2550,30
708,10205,763,2560,2610,50
709,10205,773,1440,1440,0
710,10205,811,500,500,0
711,10205,953,16180,23510,7330
712,10205,1158,210,220,10
713,10205,1186,3180,3180,0
714,10205,1236,460,740,280
715,10205,1241,3720,3720,0
716,10205,1266,57280,58260,980
717,10205,1321,62490,63460,970
718,10205,1423,67810,68820,1010
719,10205,1433,92420,93130,710
720,10205,1540,57180,59800,2620
721,10205,1647,95270,96790,1520
722,10205,1653,176250,177120,870
723,10205,1654,80350,82790,2440
724,10205,1689,10560,12470,1910
725,10205,1689,53050,71000,17950
726,10205,1689,76680,77850,1170
727,10205,1790,311630,312340,710
728,10207,971,1290,1540,250
729,10207,1281,98330,99210,880
730,10207,2564,10840,11330,490
731,10222,352,99270,99710,440
732,10222,352,137960,139170,1210
733,10222,3098,40880,41180,300
734,10222,3099,1070,1720,650
735,10502,677,260,2680,2420
736,10502,740,3600,3600,0
737,10502,1162,2740,5200,2460
738,10502,1339,67540,68690,1150
739,10502,1465,66200,67110,910
740,10502,1534,13810,20030,6220
741,10502,1557,66640,67970,1330
742,10502,1675,8940,10040,1100
743,10502,1787,60440,62110,1670
744,10502,1901,11010,12700,1690
745,10502,2132,420,480,60
746,10502,2201,800,1220,420
747,10502,2223,500,750,250
748,10502,2321,380,900,520
749,10502,2437,190,500,310
750,10502,2488,250,520,270
751,10502,2799,7360,7830,470
752,10502,2799,9560,10030,470
753,10502,2857,330,1250,920
754,10502,2861,770,1580,810
755,10502,3318,7730,11990,4260
756,10502,3319,1030,1500,470
757,10510,471,49910,52360,2450
758,10510,471,58380,59270,890
759,10510,1607,2270,2620,350
760,10510,2934,39520,40270,750
761,10510,2935,59690,60780,1090
762,10557,388,200,760,560
763,10557,1971,184600,224040,39440
764,10557,1981,86010,86530,520
765,10557,1982,197560,247620,50060
766,10557,1986,21940,85800,63860
767,10557,1991,7260,7720,460
768,10557,1991,54990,94770,39780
769,10557,2070,154070,180060,25990
770,10569,1821,45950,49730,3780
771,10570,6021,56710,58500,1790
772,10571,3114,29960,30300,340
773,10571,3114,33940,35040,1100
774,10571,3116,105950,106380,430
775,10571,3116,110420,113090,2670
776,10571,3119,94890,95230,340
777,10571,3122,31960,32290,330
778,10571,3123,300,680,380
779,10571,3124,151800,152290,490
780,10571,3134,132840,133330,490
781,10571,3135,200,330,130
782,10572,20,95640,96090,450
783,10572,25,88180,88600,420
784,10572,26,2260,2700,440
785,10572,27,82140,82820,680
786,10572,28,3530,4030,500
787,10572,40,92130,92560,430
788,10572,41,1780,1990,210
789,10572,42,96780,97170,390
790,10572,46,110770,111190,420
791,10572,48,95800,97250,1450
792,10572,52,95340,96250,910
793,10572,61,99530,99960,430
794,10572,61,103610,104120,510
795,10572,66,88390,88850,460
796,10572,67,3230,3880,650
797,10572,72,82140,82580,440
798,10572,74,96500,97100,600
799,10572,98,80110,80570,460
800,10572,107,105070,105530,460
801,10572,107,108610,109160,550
802,10572,109,77040,77320,280
803,10572,109,83140,83690,550
804,10572,134,105180,105630,450
805,10572,137,105390,105860,470
806,10572,146,85760,86140,380
807,10572,146,90450,90990,540
808,10572,151,88730,89170,440
809,10572,161,82670,82980,310
810,10572,173,111890,112350,460
811,10572,174,650,2600,1950
812,10572,175,102530,103030,500
813,10572,180,90280,90700,420
814,10572,180,94900,95520,620
815,10572,183,124150,124550,400
816,10572,183,130030,130620,590
817,10572,185,135330,136060,730
818,10572,206,85990,86390,400
819,10572,206,89720,90210,490
820,10572,208,89920,90330,410
821,10572,215,87820,88270,450
822,10572,220,80200,80710,510
823,10572,221,860,1370,510
824,10572,224,119720,120090,370
825,10573,456,118700,120430,1730
826,10573,616,65930,67560,1630
827,10574,1564,10870,12780,1910
828,10574,2369,6630,6820,190
829,10574,2982,100140,101910,1770
830,10574,2989,138010,140290,2280
831,10574,2990,2410,2910,500
832,10574,3446,24930,26320,1390
833,10575,1463,9070,9130,60
834,10582,2909,13350,13350,0
835,10584,22,8130,10350,2220
836,10584,24,29280,31500,2220
837,10584,29,78140,87400,9260
838,10584,44,33210,35870,2660
839,10584,46,35530,38830,3300
840,10584,48,31780,33770,1990
841,10584,51,40850,43040,2190
842,10584,64,25670,27170,1500
843,10584,76,35230,53140,17910
844,10584,76,57050,73650,16600
845,10584,76,74710,75930,1220
846,10584,78,8510,10170,1660
847,10584,79,210,590,380
848,10584,86,24040,25380,1340
849,10584,89,29550,33850,4300
850,10584,92,29390,31510,2120
851,10584,121,26330,28220,1890
852,10584,125,31990,34360,2370
853,10584,127,31400,33630,2230
854,10584,130,26590,28920,2330
855,10584,149,29210,31380,2170
856,10584,153,27830,30370,2540
857,10584,159,28210,30480,2270
858,10584,165,55700,57830,2130
859,10584,179,38080,40910,2830
860,10584,181,28910,30820,1910
861,10584,184,31640,33610,1970
862,10584,198,30220,32100,1880
863,10584,202,26270,28800,2530
864,10584,203,200,17360,17160
865,10584,208,28290,30350,2060
866,10584,209,30640,30720,80
867,10584,210,3360,4120,760
868,10584,212,63530,65710,2180
869,10584,214,30920,33150,2230
870,10584,215,200,9830,9630
871,10584,229,28510,30650,2140
872,10584,235,26930,30100,3170
873,10584,238,82780,85510,2730
874,10584,243,35700,38380,2680
875,10584,266,27140,29430,2290
876,10584,271,29900,31230,1330
877,10584,279,27930,29750,1820
878,10584,282,30190,32930,2740
879,10584,285,28370,29760,1390
880,10584,287,53060,54870,1810
881,10584,288,200,2650,2450
882,10584,304,29040,31120,2080
883,10584,310,24220,26260,2040
884,10584,311,2050,15230,13180
885,10584,319,29370,32690,3320
886,10584,325,28330,31740,3410
887,10584,327,32670,34860,2190
888,10584,348,25910,28070,2160
889,10584,349,2700,4060,1360
890,10584,356,34690,36850,2160
891,10584,368,32010,33900,1890
892,10584,388,32350,34390,2040
893,10584,393,24060,25960,1900
894,10584,400,31870,33920,2050
895,10584,402,33820,35930,2110
896,10584,405,19700,21080,1380
897,10584,422,6990,11610,4620
898,10584,425,30350,33170,2820
899,10584,428,32520,38240,5720
900,10584,431,18310,20890,2580
901,10584,457,43710,45910,2200
902,10584,459,28170,39280,11110
903,10584,463,36710,39590,2880
904,10584,472,26440,30940,4500
905,10584,476,32080,40070,7990
906,10584,482,25210,29390,4180
907,10584,484,37420,41140,3720
908,10584,487,28210,34200,5990
909,10584,493,27070,29710,2640
910,10584,559,64490,67080,2590
911,10584,584,29950,37360,7410
912,10584,588,69300,71040,1740
913,10584,591,31870,34330,2460
914,10584,593,49350,51770,2420
915,10584,612,28610,32040,3430
916,10584,617,26990,32410,5420
917,10584,622,32000,43270,11270
918,10584,625,66710,71640,4930
919,10584,639,35820,39800,3980
920,10584,644,21750,24300,2550
921,10584,648,33930,40000,6070
922,10584,650,33990,38700,4710
923,10584,652,53980,57330,3350
924,10584,672,25960,28680,2720
925,10584,676,29030,31850,2820
926,10584,677,200,1370,1170
927,10584,678,30670,33480,2810
928,10584,680,28170,47060,18890
929,10584,703,17970,23830,5860
930,10584,706,69380,72090,2710
931,10584,711,31270,35100,3830
932,10584,715,26320,29480,3160
933,10584,737,31670,34150,2480
934,10584,761,18310,22080,3770
935,10584,765,32670,37200,4530
936,10584,768,30970,33710,2740
937,10584,772,29480,32800,3320
938,10584,780,28160,31870,3710
939,10584,782,31840,35340,3500
940,10584,791,53200,56270,3070
941,10584,797,11510,15570,4060
942,10584,798,360,3440,3080
943,10584,801,15350,17510,2160
944,10584,803,31310,34290,2980
945,10584,823,33240,36170,2930
946,10584,826,32050,34440,2390
947,10584,830,29730,34520,4790
948,10584,832,32770,36130,3360
949,10584,862,29410,37260,7850
950,10584,866,34340,37820,3480
951,10584,871,27870,29500,1630
952,10584,873,43800,47520,3720
953,10584,878,27140,30430,3290
954,10584,885,32300,39750,7450
955,10584,893,29390,33410,4020
956,10584,894,3070,4440,1370
957,10584,895,30160,33240,3080
958,10584,916,27290,29640,2350
959,10584,918,28490,31850,3360
960,10584,920,31210,34670,3460
961,10584,925,93810,97180,3370
962,10584,930,37390,42460,5070
963,10584,933,25910,29270,3360
964,10584,953,26610,30040,3430
965,10584,957,29920,33030,3110
966,10584,960,29020,32870,3850
967,10584,967,38250,42350,4100
968,10584,980,18030,20780,2750
969,10584,982,29510,33670,4160
970,10584,985,24960,29570,4610
971,10584,987,28900,31620,2720
972,10584,1004,7800,13740,5940
973,10584,1006,19230,21260,2030
974,10584,1008,28680,33230,4550
975,10584,1010,27510,41220,13710
976,10584,1012,41480,49960,8480
977,10584,1017,34770,37460,2690
978,10584,1026,27880,32260,4380
979,10584,1029,29710,32860,3150
980,10584,1033,27710,35470,7760
981,10584,1036,50100,58740,8640
982,10584,1042,7740,10520,2780
983,10584,1043,270,4560,4290
984,10584,1073,66320,71400,5080
985,10584,1076,29390,33310,3920
986,10584,1080,27770,31760,3990
987,10584,1097,7490,8840,1350
988,10584,1100,19400,22160,2760
989,10584,1104,28500,31570,3070
990,10584,1107,24670,28530,3860
991,10584,1111,28920,31910,2990
992,10584,1116,22090,24220,2130
993,10584,1129,26270,29080,2810
994,10584,1132,26940,30650,3710
995,10584,1137,11380,16950,5570
996,10584,1139,31850,35130,3280
997,10584,1144,27730,31800,4070
998,10584,1146,30120,32720,2600
999,10584,1166,18070,20490,2420
1000,10584,1170,52930,55580,2650
1001,10585,1643,59770,61150,1380
1002,10587,221,35510,37140,1630
1003,10587,323,15780,20530,4750
1004,10587,548,550,700,150
1005,10587,894,28660,29370,710
1006,10587,1366,16290,16680,390
1007,10587,1366,26740,27910,1170
1008,10587,1501,23220,24620,1400
1009,10587,1538,53170,53660,490
1010,10587,1538,55480,56110,630
1011,10587,1560,44640,45280,640
1012,10587,1560,48680,49760,1080
1013,10587,1589,48690,49460,770
1014,10587,1620,109470,110690,1220
1015,10587,1634,35770,36270,500
1016,10587,1695,45360,51650,6290
1017,10587,1811,47010,47330,320
1018,10587,1812,950,2510,1560
1019,10587,1871,48600,53980,5380
1020,10587,1873,33020,35640,2620
1021,10587,1988,66080,66620,540
1022,10587,1989,5570,6780,1210
1023,10587,2050,58440,94580,36140
1024,10587,2052,25000,25550,550
1025,10587,2077,46160,46600,440
1026,10587,2078,680,1170,490
1027,10587,2089,28650,34480,5830
1028,10587,2090,27340,33410,6070
1029,10587,2221,143660,150900,7240
1030,10587,2222,22530,28520,5990
1031,10587,2316,26470,26900,430
1032,10587,2317,2710,3380,670
1033,10587,2380,54780,55150,370
1034,10587,2381,2300,4000,1700
1035,10587,2476,22750,23280,530
1036,10587,2476,29680,30420,740
1037,10587,2478,27380,27840,460
1038,10587,2478,31840,33330,1490
1039,10587,2482,23160,23830,670
1040,10587,2482,27400,31660,4260
1041,10587,2518,860,1650,790
1042,10587,2533,30670,31140,470
1043,10587,2533,34940,39480,4540
1044,10587,2534,2670,2690,20
1045,10587,2564,35190,35570,380
1046,10587,2564,40360,41300,940
1047,10587,2565,9120,10000,880
1048,10587,2745,39890,40040,150
1049,10587,3040,23430,23880,450
1050,10587,3040,29130,29880,750
1051,10587,3204,67060,67590,530
1052,10587,3205,1810,3110,1300
1053,10587,3245,67740,74960,7220
1054,10587,3246,5800,6230,430
1055,10587,3285,47290,73840,26550
1056,10587,3301,46370,46750,380
1057,10587,3358,5860,5870,10
1058,10587,3358,7210,7220,10
1059,10587,3431,49770,50140,370
1060,10587,3432,830,1940,1110
1061,10587,3468,47550,48060,510
1062,10587,3541,46860,62430,15570
1063,10587,3558,12310,12740,430
1064,10587,3558,17330,17920,590
1065,10587,3684,41420,41750,330
1066,10587,3988,70560,71010,450
1067,10587,3989,8450,8880,430
1068,10587,4052,48420,48810,390
1069,10587,4053,7180,15370,8190
1070,10587,4062,53910,54340,430
1071,10587,4063,5900,6150,250
1072,10587,4065,17660,18030,370
1073,10587,4066,1320,1870,550
1074,10587,4145,20420,20780,360
1075,10587,4146,2660,3170,510
1076,10587,4150,3800,3820,20
1077,10587,4711,52980,53370,390
1078,10587,4712,1050,1570,520
1079,10587,4719,85940,86310,370
1080,10587,4720,11010,12130,1120
1081,10587,4930,43990,44360,370
1082,10587,4931,190,570,380
1083,10587,5011,51590,52010,420
1084,10587,5012,370,1480,1110
1085,10587,5281,26210,26630,420
1086,10587,5282,1360,1840,480
1087,10587,5623,43260,43610,350
1088,10587,5624,1350,1930,580
1089,10593,239,2400,3360,960
1090,10593,791,23050,29650,6600
1091,10593,791,36290,44350,8060
1092,10593,815,20910,22700,1790
1093,10593,815,30020,37960,7940
1094,10593,816,190,4720,4530
1095,10595,2890,148050,149930,1880
1096,10595,4809,154520,164440,9920
1097,10604,884,3370,3560,190
1098,10605,5561,243970,245230,1260
1099,10605,5957,108530,110050,1520
1100,10605,7467,90620,94420,3800
1101,10605,7468,2450,2990,540
1102,10605,8924,2730,2850,120
1103,10605,10316,83790,85370,1580
1104,10607,352,186130,196770,10640
1105,10607,353,104430,120810,16380
1106,10607,355,222800,231060,8260
1107,10607,356,107080,145070,37990
1108,10607,360,118040,132220,14180
1109,10607,361,248590,257190,8600
1110,10607,362,125320,146960,21640
1111,10607,367,298970,307820,8850
1112,10607,371,8030,15980,7950
1113,10607,391,100870,116210,15340
1114,10607,394,101230,108600,7370
1115,10607,395,210,710,500
1116,10607,396,195910,202300,6390
1117,10607,402,98900,156900,58000
1118,10607,409,202770,213040,10270
1119,10607,412,102940,159110,56170
1120,10607,428,214140,222300,8160
1121,10607,429,108570,115130,6560
1122,10607,431,275830,285080,9250
1123,10607,432,110290,125660,15370
1124,10607,436,250930,259630,8700
1125,10607,437,106210,112320,6110
1126,10607,438,242620,250890,8270
1127,10607,439,97100,138580,41480
1128,10607,440,266150,275290,9140
1129,10607,443,89830,144740,54910
1130,10607,459,374870,383470,8600
1131,10607,461,111350,116860,5510
1132,10607,463,238290,247710,9420
1133,10607,464,87350,99690,12340
1134,10607,465,210,3350,3140
1135,10607,468,219620,228340,8720
1136,10607,471,100450,139390,38940
1137,10607,473,206370,215320,8950
1138,10607,474,106330,171780,65450
1139,10607,476,199620,208490,8870
1140,10607,479,96980,102010,5030
1141,10607,480,240,6810,6570
1142,10607,500,234510,242980,8470
1143,10607,501,98610,105130,6520
1144,10607,506,218280,226560,8280
1145,10607,508,97460,118190,20730
1146,10607,674,239760,247920,8160
1147,10607,675,91090,125080,33990
1148,10607,678,258660,267160,8500
1149,10607,679,90380,122230,31850
1150,10607,682,221880,230190,8310
1151,10607,684,108390,112780,4390
1152,10607,685,223210,230950,7740
1153,10607,688,96660,104340,7680
1154,10607,692,225450,233940,8490
1155,10607,693,109720,124300,14580
1156,10607,709,271980,281600,9620
1157,10607,710,127590,158620,31030
1158,10607,712,243500,251900,8400
1159,10607,713,96260,110050,13790
1160,10607,715,269080,277690,8610
1161,10607,716,104870,114450,9580
1162,10607,716,115540,120180,4640
1163,10607,720,196030,203810,7780
1164,10607,721,94460,101530,7070
1165,10607,722,234960,250970,16010
1166,10607,723,106920,113290,6370
1167,10607,726,291770,310910,19140
1168,10607,731,106130,114240,8110
1169,10607,736,332580,343010,10430
1170,10607,738,106750,215080,108330
1171,10607,741,290560,303290,12730
1172,10607,742,102530,115550,13020
1173,10607,744,246580,257460,10880
1174,10607,745,109710,118030,8320
1175,10607,747,184240,193060,8820
1176,10607,751,11090,49990,38900
1177,10607,767,291930,300680,8750
1178,10607,768,100030,120070,20040
1179,10607,771,185530,194800,9270
1180,10607,772,119960,153200,33240
1181,10607,783,177940,178560,620
1182,10607,784,8260,8980,720
1183,10607,785,243040,263890,20850
1184,10607,786,104140,143380,39240
1185,10607,802,448510,458180,9670
1186,10607,803,131590,179650,48060
1187,10607,804,392490,401410,8920
1188,10607,805,102300,105630,3330
1189,10607,805,106940,144340,37400
1190,10607,820,345650,355930,10280
1191,10607,821,113160,140530,27370
1192,10607,823,381170,389850,8680
1193,10607,824,119000,127380,8380
1194,10607,825,256140,265820,9680
1195,10607,826,114600,189660,75060
1196,10607,830,331990,344740,12750
1197,10607,834,110890,128310,17420
1198,10607,844,254740,264810,10070
1199,10607,845,97540,114490,16950
1200,10607,848,191470,200140,8670
1201,10607,850,106240,152490,46250
1202,10607,853,257880,266290,8410
1203,10607,854,104410,114120,9710
1204,10607,857,251260,260910,9650
1205,10607,858,150460,155040,4580
1206,10607,859,250,9030,8780
1207,10607,860,339920,368800,28880
1208,10607,861,103420,143530,40110
1209,10607,877,143660,174310,30650
1210,10607,878,200,200,0
1211,10607,887,290810,301040,10230
1212,10607,891,109240,119990,10750
1213,10607,893,433580,442070,8490
1214,10607,894,106330,179370,73040
1215,10607,896,286780,295780,9000
1216,10607,897,113890,124470,10580
1217,10607,905,437210,447360,10150
1218,10607,906,124400,132850,8450
1219,10607,908,297400,306830,9430
1220,10607,909,101110,124050,22940
1221,10607,912,264030,271430,7400
1222,10607,914,97300,108780,11480
1223,10607,915,310730,321090,10360
1224,10607,916,103480,107840,4360
1225,10607,917,200,7130,6930
1226,10607,918,102480,105090,2610
1227,10607,919,220,1020,800
1228,10607,936,93640,104800,11160
1229,10607,939,274800,276340,1540
1230,10607,939,300790,311760,10970
1231,10607,940,105900,117300,11400
1232,10607,945,125660,140390,14730
1233,10607,1407,170350,173220,2870
1234,10607,1609,171380,172820,1440
1235,10607,1612,20680,22760,2080
1236,10607,1613,210,520,310
1237,10607,4640,203640,204760,1120
1238,10607,5504,258200,263200,5000
1239,10611,4215,85570,89830,4260
1240,10612,2473,8080,8640,560
1241,10612,2480,15340,15740,400
1242,10612,2481,1050,4110,3060
1243,10612,3257,6420,6740,320
1244,10612,3535,12560,13010,450
1245,10612,3536,4490,5960,1470
1246,10612,4206,15860,16450,590
1247,10612,5252,700,1170,470
1248,10612,5537,400,1010,610
1249,10612,5592,530,610,80
1250,10612,5636,1800,1840,40
1251,10612,5636,3070,3250,180
1252,10612,5658,1720,2020,300
1253,10612,5658,3360,3360,0
1254,10612,5752,410,410,0
1255,10612,5766,53970,54750,780
1256,10612,5766,56690,58050,1360
1257,10612,5828,710,710,0
1258,10612,5836,680,1740,1060
1259,10612,5848,500,810,310
1260,10612,5919,190,320,130
1261,10616,321,1410,1520,110
1262,10616,336,18230,21960,3730
1263,10616,943,10580,14990,4410
1264,10616,977,32070,36030,3960
1265,10616,978,25550,31910,6360
1266,10616,978,67230,71290,4060
1267,10616,1833,200300,201230,930
1268,10616,1833,203700,205250,1550
1269,10616,2172,860,1150,290
1270,10617,231,4360,4990,630
1271,10618,55,102780,103270,490
1272,10618,55,110760,111360,600
1273,10618,56,101730,104020,2290
1274,10618,79,68870,69360,490
1275,10618,79,75180,76630,1450
1276,10618,80,120090,121850,1760
1277,10618,112,97260,98870,1610
1278,10618,113,151210,153020,1810
1279,10618,122,144210,145940,1730
1280,10618,126,10930,11500,570
1281,10618,126,17670,18330,660
1282,10618,134,5640,7410,1770
1283,10618,138,163480,165880,2400
1284,10618,158,120490,122400,1910
1285,10618,159,6770,9020,2250
1286,10618,168,123810,125420,1610
1287,10618,178,14620,17730,3110
1288,10618,185,149520,150640,1120
1289,10618,185,155030,155840,810
1290,10618,186,7590,9760,2170
1291,10618,213,7890,10190,2300
1292,10618,217,95370,97540,2170
1293,10618,219,11820,14570,2750
1294,10618,222,73040,73830,790
1295,10618,222,85490,89250,3760
1296,10618,222,101340,101870,530
1297,10618,222,113680,114250,570
1298,10618,224,21300,21970,670
1299,10618,224,31680,32890,1210
1300,10618,224,36510,44880,8370
1301,10618,227,8880,9670,790
1302,10618,227,30090,30900,810
1303,10618,230,10870,11670,800
1304,10618,230,16060,16850,790
1305,10618,234,98380,98940,560
1306,10618,234,102920,103810,890
1307,10618,234,119860,121600,1740
1308,10618,235,11620,12970,1350
1309,10618,235,19930,42910,22980
1310,10618,235,53220,67550,14330
1311,10618,237,207570,208340,770
1312,10618,237,214010,215180,1170
1313,10618,237,222960,224480,1520
1314,10618,238,8810,10970,2160
1315,10618,251,6080,6590,510
1316,10618,251,12710,65770,53060
1317,10618,252,87330,87880,550
1318,10618,252,91110,91700,590
1319,10618,253,15120,15720,600
1320,10618,253,20620,21300,680
1321,10618,273,263780,264290,510
1322,10618,273,271310,294150,22840
1323,10618,274,208350,210200,1850
1324,10618,275,13170,13800,630
1325,10618,275,35720,36450,730
1326,10618,276,15380,15910,530
1327,10618,276,19440,19970,530
1328,10618,277,6330,6880,550
1329,10618,277,11470,12160,690
1330,10618,282,212640,213640,1000
1331,10618,282,218210,218750,540
1332,10618,283,6380,6940,560
1333,10618,283,14200,43900,29700
1334,10618,289,132530,133480,950
1335,10618,289,137620,138150,530
1336,10618,290,6660,7210,550
1337,10618,290,12040,12790,750
1338,10618,291,5640,7600,1960
1339,10618,301,141670,142310,640
1340,10618,301,146290,146810,520
1341,10618,302,5390,5780,390
1342,10618,302,16390,16880,490
1343,10618,308,6660,8580,1920
1344,10618,309,115830,116410,580
1345,10618,309,129470,130050,580
1346,10618,312,7860,8450,590
1347,10618,312,12670,13320,650
1348,10618,324,150570,153490,2920
1349,10618,336,70290,71020,730
1350,10618,336,74470,75100,630
1351,10618,337,122260,123760,1500
1352,10618,338,6080,6490,410
1353,10618,338,12040,13700,1660
1354,10618,349,86250,87790,1540
1355,10618,350,9710,10200,490
1356,10618,350,13360,14080,720
1357,10618,353,9560,10080,520
1358,10618,353,15100,16920,1820
1359,10618,357,6230,6740,510
1360,10618,357,20180,20770,590
1361,10618,359,82040,82690,650
1362,10618,359,95840,97550,1710
1363,10618,360,7730,8380,650
1364,10618,360,12870,13770,900
1365,10618,373,5100,7180,2080
1366,10618,378,15030,15640,610
1367,10618,378,22340,36330,13990
1368,10618,378,52700,54030,1330
1369,10618,379,4740,5360,620
1370,10618,379,8280,9040,760
1371,10618,384,191180,192210,1030
1372,10618,384,195630,196160,530
1373,10618,385,6590,7110,520
1374,10618,385,11550,12240,690
1375,10618,387,102490,103230,740
1376,10618,387,106460,107130,670
1377,10618,389,5610,7920,2310
1378,10618,393,7500,9280,1780
1379,10618,394,116960,117730,770
1380,10618,394,121490,121940,450
1381,10618,395,5700,6880,1180
1382,10618,395,15020,15720,700
1383,10618,401,160390,160900,510
1384,10618,401,164370,164980,610
1385,10618,402,15650,16180,530
1386,10618,402,31850,40730,8880
1387,10618,402,51650,52860,1210
1388,10618,403,8890,9440,550
1389,10618,403,21370,22140,770
1390,10618,424,9010,9620,610
1391,10618,424,14890,16000,1110
1392,10618,425,79720,80940,1220
1393,10618,429,3280,4410,1130
1394,10618,439,10410,11090,680
1395,10618,439,24930,25610,680
1396,10618,439,36110,37930,1820
1397,10618,441,154900,155450,550
1398,10618,441,160410,160990,580
1399,10618,445,7180,7850,670
1400,10618,445,12490,13430,940
1401,10618,448,34070,34630,560
1402,10618,448,45170,59860,14690
1403,10618,448,71300,73430,2130
1404,10618,449,9130,11690,2560
1405,10618,452,11360,12060,700
1406,10618,452,17690,18670,980
1407,10618,456,8650,9620,970
1408,10618,456,13610,14410,800
1409,10618,458,93030,93660,630
1410,10618,458,97230,98080,850
1411,10618,458,107630,109080,1450
1412,10618,459,8320,8800,480
1413,10618,459,15620,16350,730
1414,10618,462,12510,13080,570
1415,10618,462,21530,22390,860
1416,10618,466,6600,17400,10800
1417,10618,471,88000,89400,1400
1418,10618,471,92830,93420,590
1419,10618,476,5490,7500,2010
1420,10618,480,22790,23360,570
1421,10618,480,26160,68670,42510
1422,10618,481,190630,191080,450
1423,10618,481,218650,257030,38380
1424,10618,482,6410,6910,500
1425,10618,482,13300,17220,3920
1426,10618,487,185530,186860,1330
1427,10618,488,6830,7500,670
1428,10618,489,4520,6340,1820
1429,10618,492,107250,107870,620
1430,10618,492,111420,111900,480
1431,10618,493,7860,8580,720
1432,10618,493,14770,15740,970
1433,10618,493,127710,128640,930
1434,10618,493,131950,132800,850
1435,10618,493,141550,142900,1350
1436,10618,494,6620,7230,610
1437,10618,494,10370,11330,960
1438,10618,497,116970,117700,730
1439,10618,497,121990,124170,2180
1440,10618,498,15550,16030,480
1441,10618,498,25670,57170,31500
1442,10618,499,315580,317800,2220
1443,10618,504,85800,86960,1160
1444,10618,509,6970,7510,540
1445,10618,509,10170,10370,200
1446,10618,509,11500,12440,940
1447,10618,511,83160,83590,430
1448,10618,511,89440,105810,16370
1449,10618,511,114820,116950,2130
1450,10618,512,9850,10810,960
1451,10618,512,26850,27700,850
1452,10618,514,155560,155990,430
1453,10618,514,161750,162340,590
1454,10618,515,13290,14900,1610
1455,10618,515,17450,17910,460
1456,10618,519,200980,202040,1060
1457,10618,519,205240,205780,540
1458,10618,522,101890,102340,450
1459,10618,522,106660,107180,520
1460,10618,525,7840,10380,2540
1461,10618,526,91870,92520,650
1462,10618,526,97680,98460,780
1463,10618,535,8260,11740,3480
1464,10618,565,8800,9380,580
1465,10618,565,19910,21160,1250
1466,10618,566,342020,344350,2330
1467,10618,567,10430,11630,1200
1468,10618,567,14840,15740,900
1469,10618,570,19890,20470,580
1470,10618,570,23720,24220,500
1471,10618,571,9300,11810,2510
1472,10618,572,106810,108650,1840
1473,10618,579,146300,147610,1310
1474,10618,580,6070,6610,540
1475,10618,580,14550,45600,31050
1476,10618,586,121640,122290,650
1477,10618,586,132400,132960,560
1478,10618,595,153400,154130,730
1479,10618,595,162230,188030,25800
1480,10618,597,119120,120620,1500
1481,10618,598,8750,10520,1770
1482,10618,605,151170,151920,750
1483,10618,605,157410,158130,720
1484,10618,607,143940,167410,23470
1485,10618,607,176120,176730,610
1486,10618,608,6820,8470,1650
1487,10618,614,6230,8530,2300
1488,10618,630,176100,178240,2140
1489,10618,634,11090,14190,3100
1490,10618,641,11690,14820,3130
1491,10618,650,10420,20040,9620
1492,10618,658,98420,99940,1520
1493,10618,660,9550,12290,2740
1494,10618,663,9150,11710,2560
1495,10618,666,46170,46810,640
1496,10618,666,51240,52190,950
1497,10618,669,146500,147160,660
1498,10618,669,153000,153580,580
1499,10618,670,10060,10700,640
1500,10618,670,13870,14870,1000
1501,10618,673,29620,32040,2420
1502,10618,676,8560,10270,1710
1503,10618,689,13240,15240,2000
1504,10618,699,10510,11350,840
1505,10618,699,22540,24410,1870
1506,10618,702,8140,27920,19780
1507,10618,713,531680,544380,12700
1508,10618,713,565330,566040,710
1509,10618,714,31330,33530,2200
1510,10618,716,17470,19720,2250
1511,10618,721,144160,144730,570
1512,10618,721,153940,154510,570
1513,10618,722,8200,10650,2450
1514,10618,727,173440,174910,1470
1515,10618,728,194270,195060,790
1516,10618,728,205980,231330,25350
1517,10618,735,197150,197730,580
1518,10618,736,28370,29770,1400
1519,10618,737,8470,10800,2330
1520,10618,743,11450,12210,760
1521,10618,743,21470,45590,24120
1522,10618,754,6810,35910,29100
1523,10618,756,188520,189160,640
1524,10618,756,194530,195180,650
1525,10618,757,7790,8310,520
1526,10618,757,30860,31740,880
1527,10618,770,7490,9280,1790
1528,10618,776,10350,12360,2010
1529,10618,781,167870,168460,590
1530,10618,781,179220,201600,22380
1531,10618,782,32440,34440,2000
1532,10618,788,108590,110590,2000
1533,10618,799,9430,11630,2200
1534,10618,801,166890,169060,2170
1535,10618,809,195910,196520,610
1536,10618,809,202330,212760,10430
1537,10618,816,114720,116070,1350
1538,10618,819,129050,131240,2190
1539,10618,820,9550,10280,730
1540,10618,820,17180,18230,1050
1541,10618,840,190670,196880,6210
1542,10618,841,12290,19010,6720
1543,10618,841,26740,27370,630
1544,10618,846,215880,221730,5850
1545,10618,846,225660,226220,560
1546,10618,848,127800,144620,16820
1547,10618,848,151480,153020,1540
1548,10618,849,6130,12280,6150
1549,10618,852,134610,136320,1710
1550,10618,857,4060,5130,1070
1551,10618,875,214310,215730,1420
1552,10618,898,7000,7460,460
1553,10618,898,12640,13560,920
1554,10618,907,8910,36140,27230
1555,10618,907,46420,46930,510
1556,10618,907,65700,67490,1790
1557,10618,939,182310,184060,1750
1558,10618,940,8970,15230,6260
1559,10618,940,20680,21940,1260
1560,10618,943,164150,166360,2210
1561,10618,944,6680,8680,2000
1562,10618,946,121860,123440,1580
1563,10618,947,8010,10290,2280
1564,10618,948,119500,119930,430
1565,10618,948,125460,125990,530
1566,10618,949,7130,8330,1200
1567,10618,952,7890,9670,1780
1568,10618,979,215400,217030,1630
1569,10618,980,8000,10000,2000
1570,10618,991,7530,9100,1570
1571,10618,999,10060,11710,1650
1572,10618,1006,15110,16870,1760
1573,10618,1014,186620,188430,1810
1574,10618,1025,154760,157490,2730
1575,10618,1027,13370,16290,2920
1576,10618,1033,4390,8000,3610
1577,10618,1033,11640,15680,4040
1578,10618,1036,109020,111200,2180
1579,10618,1039,37180,39930,2750
1580,10618,1042,92130,93950,1820
1581,10618,1043,9250,14160,4910
1582,10618,1049,147180,148640,1460
1583,10618,1055,4890,6520,1630
1584,10618,1059,6860,29900,23040
1585,10618,1059,37520,38030,510
1586,10618,1059,48300,49030,730
1587,10618,1059,54150,54860,710
1588,10618,1068,5460,6910,1450
1589,10618,1079,73330,74700,1370
1590,10618,1089,4780,5940,1160
1591,10618,1093,10810,25580,14770
1592,10618,1098,6060,8050,1990
1593,10618,1099,272840,274270,1430
1594,10618,1100,13040,15130,2090
1595,10618,1118,16450,18200,1750
1596,10618,1128,6570,8140,1570
1597,10618,1131,6550,7860,1310
1598,10618,1135,4560,5610,1050
1599,10618,1147,227750,229440,1690
1600,10618,1148,7550,9440,1890
1601,10618,1152,153350,155330,1980
1602,10618,1164,146620,171780,25160
1603,10618,1164,182220,193180,10960
1604,10618,1165,8690,10260,1570
1605,10618,1173,31680,36390,4710
1606,10618,1176,6550,47040,40490
1607,10618,1188,10010,37550,27540
1608,10618,1188,60570,62570,2000
1609,10618,1189,240080,242000,1920
1610,10618,1190,26170,26930,760
1611,10618,1190,32290,40820,8530
1612,10618,1190,53290,53860,570
1613,10618,1190,60140,61680,1540
1614,10618,1193,186930,188660,1730
1615,10618,1194,3800,5070,1270
1616,10618,1202,99280,100950,1670
1617,10618,1223,164970,166730,1760
1618,10618,1230,158270,201460,43190
1619,10618,1230,230950,233970,3020
1620,10618,1239,145000,146610,1610
1621,10618,1240,6320,8060,1740
1622,10618,1253,6710,10940,4230
1623,10618,1257,5050,6690,1640
1624,10618,1267,4780,6050,1270
1625,10618,1270,7180,8480,1300
1626,10618,1271,16240,17410,1170
1627,10618,1274,8430,10170,1740
1628,10618,1286,133350,135320,1970
1629,10618,1289,8430,10470,2040
1630,10618,1304,7530,8970,1440
1631,10618,1305,106320,108080,1760
1632,10618,1306,6020,37860,31840
1633,10618,1314,6140,8340,2200
1634,10618,1316,6600,7750,1150
1635,10618,1319,120500,122020,1520
1636,10618,1330,4840,6140,1300
1637,10618,1335,16100,18000,1900
1638,10618,1338,114320,116110,1790
1639,10618,1349,6590,8330,1740
1640,10618,1356,138940,140570,1630
1641,10618,1357,90890,91520,630
1642,10618,1357,120640,144610,23970
1643,10618,1357,151440,152860,1420
1644,10618,1357,174620,175130,510
1645,10618,1357,181370,181970,600
1646,10618,1358,8120,12510,4390
1647,10618,1362,96980,99090,2110
1648,10618,1363,10220,21500,11280
1649,10618,1374,148610,166110,17500
1650,10618,1376,7780,30080,22300
1651,10618,1380,24660,25330,670
1652,10618,1380,41720,56260,14540
1653,10618,1380,82570,87520,4950
1654,10618,1380,92080,92580,500
1655,10618,1381,5370,13260,7890
1656,10618,1381,18910,19400,490
1657,10618,1381,67850,68760,910
1658,10618,1381,73350,74950,1600
1659,10618,1385,61560,62190,630
1660,10618,1385,69080,86200,17120
1661,10618,1387,120070,120560,490
1662,10618,1387,130050,148540,18490
1663,10618,1388,5400,9570,4170
1664,10618,1388,16880,17350,470
1665,10618,1388,22850,23320,470
1666,10618,1388,61350,63010,1660
1667,10618,1395,5710,7320,1610
1668,10618,1433,40240,53010,12770
1669,10618,1433,58820,59320,500
1670,10618,1434,6230,7830,1600
1671,10618,1435,186740,188270,1530
1672,10618,1436,8930,10480,1550
1673,10618,1470,172060,179400,7340
1674,10618,1470,184370,184930,560
1675,10618,1471,9420,46640,37220
1676,10618,1471,62810,63520,710
1677,10618,1471,86900,94090,7190
1678,10618,1471,132770,133250,480
1679,10618,1471,140040,141310,1270
1680,10618,1483,178950,180610,1660
1681,10618,1484,47940,50390,2450
1682,10618,1485,209300,211050,1750
1683,10618,1486,25760,35080,9320
1684,10618,1486,39700,41110,1410
1685,10618,1488,161290,163150,1860
1686,10618,1490,22370,24130,1760
1687,10618,1496,8030,9710,1680
1688,10618,1505,7230,8760,1530
1689,10618,1506,156060,157800,1740
1690,10618,1507,7170,9190,2020
1691,10618,1520,6950,8670,1720
1692,10618,1521,144550,146460,1910
1693,10618,1532,8080,9930,1850
1694,10618,1549,134880,136710,1830
1695,10618,1550,13690,15280,1590
1696,10618,1553,208370,209990,1620
1697,10618,1554,7330,39040,31710
1698,10618,1563,151090,160900,9810
1699,10618,1563,169690,170190,500
1700,10618,1566,12740,38250,25510
1701,10618,1566,50500,50940,440
1702,10618,1569,8560,10250,1690
1703,10618,1575,107180,108790,1610
1704,10618,1581,170530,172290,1760
1705,10618,1582,6540,8190,1650
1706,10619,1441,158870,163810,4940
1707,10619,1441,165670,166020,350
1708,10620,5049,1340,2610,1270
1709,13000,1120,240,1080,840
1710,13101,1065,16440,17290,850
1711,13101,1065,20810,22680,1870
1712,13103,9590,123290,124270,980
1713,13103,9590,125360,127290,1930
1714,13105,14812,243440,244220,780
1715,13105,14812,246470,248040,1570
1716,13106,18025,31020,37810,6790
1717,13107,164,62570,64790,2220
1718,13107,165,15950,17570,1620
1719,13107,321,34380,36260,1880
1720,13107,322,14370,16080,1710
1721,13107,434,35620,37830,2210
1722,13107,679,60260,61910,1650
1723,13107,3356,5100,6160,1060
1724,13107,3727,29960,32020,2060
1725,13107,3778,32900,35200,2300
1726,13107,3835,35230,37110,1880
1727,13107,3836,4480,6700,2220
1728,13107,3972,57410,59550,2140
1729,13107,4135,36090,38390,2300
1730,13107,4195,42790,44590,1800
1731,13107,4278,40580,40910,330
1732,13107,4278,41980,42550,570
1733,13107,4351,33160,34980,1820
1734,13107,4458,32920,34940,2020
1735,13107,4459,8920,10550,1630
1736,13107,4584,21440,23420,1980
1737,13107,4652,5610,5950,340
1738,13107,4728,28840,30990,2150
1739,13107,4838,64610,66960,2350
1740,13107,4839,9570,11470,1900
1741,13107,5214,38460,40380,1920
1742,13107,5215,6450,8200,1750
1743,13107,5261,46910,49020,2110
1744,13107,5262,4490,6070,1580
1745,13107,5309,40750,43230,2480
1746,13107,5310,4940,6700,1760
1747,13107,5319,9150,11150,2000
1748,13107,5395,39810,41640,1830
1749,13107,5516,103540,105330,1790
1750,13107,5590,109800,111830,2030
1751,13107,5591,4520,6120,1600
1752,13107,5623,50130,52130,2000
1753,13107,5701,43100,44810,1710
1754,13107,5702,6220,7800,1580
1755,13107,5824,105290,107100,1810
1756,13107,5921,100570,102190,1620
1757,13107,6037,25890,27630,1740
1758,13107,6263,44830,47370,2540
1759,13107,6376,55860,57760,1900
1760,13107,6377,11590,13680,2090
1761,13107,6490,38380,40540,2160
1762,13107,6589,46270,48110,1840
1763,13107,6632,48750,50880,2130
1764,13107,6710,45750,47770,2020
1765,13107,6967,53990,55830,1840
1766,13107,6968,11230,18560,7330
1767,13107,7059,54860,56560,1700
1768,13107,7170,34070,35840,1770
1769,13107,7502,114870,116640,1770
1770,13107,7544,81230,82930,1700
1771,13107,7802,62020,64700,2680
1772,13107,7952,2680,4220,1540
1773,13107,7953,4580,6760,2180
1774,13107,8007,47730,49460,1730
1775,13107,8130,44750,46760,2010
1776,13107,10056,3600,5550,1950
1777,13107,10155,4460,6330,1870
1778,13107,10511,66660,68690,2030
1779,13107,10584,1590,3040,1450
1780,13107,11031,6810,8220,1410
1781,13107,11292,4300,6380,2080
1782,13107,11329,23250,25140,1890
1783,13107,11651,58880,61210,2330
1784,13107,12030,6300,8230,1930
1785,13107,12049,63890,65580,1690
1786,13107,12067,199010,200770,1760
1787,13107,12093,23740,31710,7970
1788,13107,12175,30180,32050,1870
1789,13107,12250,2150,2960,810
1790,13107,12266,73900,75400,1500
1791,13107,12416,89330,91120,1790
1792,13107,16011,32780,34890,2110
1793,13108,798,84000,86540,2540
1794,13108,997,1260,1260,0
1795,13108,8094,5800,6380,580
1796,13108,8094,8540,8580,40
1797,13108,8567,176230,178860,2630
1798,13109,4471,48350,50550,2200
1799,13109,8660,3770,6040,2270
1800,13109,10226,64210,66370,2160
1801,13109,10226,77910,79410,1500
1802,13109,12219,18190,19260,1070
1803,13109,12325,12050,14180,2130
1804,13109,12439,16070,17800,1730
1805,13109,12440,13110,15150,2040
1806,13109,12807,14970,16560,1590
1807,13109,13044,15530,16630,1100
1808,13109,14112,12810,14240,1430
1809,13109,14230,26220,27690,1470
1810,13110,1367,15850,17480,1630
1811,13110,4709,43800,45520,1720
1812,13110,4709,63360,65670,2310
1813,15901,1,63910,65620,1710
1814,17101,609,93370,95270,1900
1815,17101,733,245900,247380,1480
1816,17101,733,427430,428710,1280
1817,17101,866,754180,757720,3540
1818,17101,1052,202810,212340,9530
1819,17101,1052,329190,330920,1730
1820,17101,1167,108260,109910,1650
1821,17101,1175,80870,82440,1570
1822,17101,1182,89690,90870,1180
1823,17101,1201,95280,96660,1380
1824,17101,1213,78070,79710,1640
1825,17101,1213,245750,248130,2380
1826,17101,1220,82780,84140,1360
1827,17101,1228,94110,95700,1590
1828,17101,1236,94590,96790,2200
1829,17101,1236,255900,257420,1520
1830,17101,1455,233020,233650,630
1831,17101,1455,237350,238760,1410
1832,17101,1498,1525080,1525680,600
1833,17101,1498,1584160,1585190,1030
1834,17101,2144,112720,113870,1150
1835,17101,2144,272880,274450,1570
1836,17101,2144,278070,278820,750
1837,17101,2144,433030,434640,1610
1838,17101,2144,437000,437760,760
1839,17101,2144,621090,629010,7920
1840,17101,2144,793860,794750,890
1841,17101,2144,797650,799490,1840
1842,17101,2144,971490,975440,3950
1843,17101,2144,978320,980090,1770
1844,17101,2144,1257910,1258570,660
1845,17101,2144,1262050,1264290,2240
1846,17101,2144,1428670,1429290,620
1847,17101,2144,1431550,1433130,1580
1848,17101,2145,1611550,1618510,6960
1849,17102,929,128150,129640,1490
1850,17102,929,132330,133290,960
1851,17102,929,333600,335240,1640
1852,17102,929,337310,338030,720
1853,17102,929,503370,505270,1900
1854,17102,929,507960,508800,840
1855,17102,929,691360,693260,1900
1856,17102,929,695850,696650,800
1857,17102,929,867220,868420,1200
1858,17102,929,870710,871440,730
1859,17102,1576,102140,102690,550
1860,17102,1576,104880,106240,1360
1861,17102,1576,252930,253720,790
1862,17102,1576,256010,257640,1630
1863,17102,1576,415080,415730,650
1864,17102,1576,417980,419540,1560
1865,17102,1576,589180,589820,640
1866,17102,1576,592460,594020,1560
1867,17102,1576,767130,767800,670
1868,17102,1576,770620,772220,1600
1869,17102,1607,78770,80210,1440
1870,17102,1607,259490,260740,1250
1871,17102,1607,431270,432810,1540
1872,17102,1607,637070,638330,1260
1873,17102,1607,826460,827720,1260
1874,17102,1607,1020850,1022180,1330
1875,17102,1669,172960,174630,1670
1876,17102,1669,380640,381210,570
1877,17102,1669,383120,384410,1290
1878,17102,1669,546830,547410,580
1879,17102,1669,549520,551000,1480
1880,17102,1669,717570,718110,540
1881,17102,1669,720420,721840,1420
1882,17102,1669,907480,908760,1280
1883,17102,1669,1110740,1111970,1230
1884,17103,849,196690,198340,1650
