Event,Device,Trip,Starttime,Endtime,Duration,Pedestrians,Stoptime
1,10120,285,127100,127340,240,2,0
2,10122,52,194220,194340,120,1,0
3,10122,58,71770,71840,70,1,0
4,10122,102,145540,145720,180,1,0
5,10122,102,146670,146820,150,1,0
6,10122,155,144230,144510,280,1,0
7,10122,206,197380,197910,530,1,0
8,10122,209,227230,227880,650,1,0
9,10122,224,181420,181530,110,1,0
10,10122,255,170670,170750,80,1,0
11,10122,257,167190,167480,290,1,0
12,10122,276,145960,146000,40,1,0
13,10122,278,201010,201220,210,2,0
14,10122,285,133950,134010,60,1,0
15,10122,286,11760,11970,210,2,0
16,10122,291,478570,478680,110,2,0
17,10122,305,158560,159590,1030,2,0
18,10122,312,140590,140690,100,2,0
19,10122,318,5350,5510,160,1,0
20,10122,331,89870,89980,110,2,0
21,10122,334,179990,180100,110,1,0
22,10122,337,220580,220600,20,4,0
23,10122,340,2630,3180,550,3,0
24,10122,348,1060,1880,820,1,0
25,10122,351,152680,152720,40,1,0
26,10122,352,3660,3720,60,2,0
27,10122,355,400,610,210,2,0
28,10122,357,135420,135580,160,2,0
29,10122,387,6960,7310,350,2,0
30,10122,403,156780,157080,300,1,0
31,10122,404,8430,8470,40,1,0
32,10122,409,134730,134910,180,2,0
33,10122,425,154250,154450,200,2,0
34,10122,426,4490,5370,880,1,0
35,10122,428,1920,2050,130,1,0
36,10122,430,181210,181230,20,2,0
37,10122,432,172770,172840,70,1,0
38,10122,433,3780,3870,90,1,0
39,10122,446,194820,194950,130,2,0
40,10122,448,165600,165800,200,2,0
41,10122,453,154650,154750,100,1,0
42,10122,456,81170,81330,160,2,0
43,10122,459,146550,146660,110,1,0
44,10122,468,7240,7550,310,1,0
45,10122,471,29770,29890,120,2,0
46,10122,479,9050,9060,10,1,0
47,10122,489,164720,165130,410,3,0
48,10122,490,4620,5160,540,2,0
49,10122,499,142280,142310,30,1,0
50,10122,518,159540,159690,150,1,0
51,10122,518,160510,160640,130,1,0
52,10122,530,210760,211380,620,1,0
53,10122,548,161310,161410,100,2,0
54,10122,551,4390,4500,110,3,0
55,10122,556,5130,5340,210,1,0
56,10122,565,146540,146880,340,2,0
57,10122,576,3030,3210,180,1,0
58,10122,577,150480,150930,450,2,0
59,10122,601,168490,168810,320,1,0
60,10122,607,159880,160110,230,2,0
61,10122,612,162780,162930,150,3,0
62,10122,622,157350,157740,390,3,0
63,10122,623,3030,3570,540,2,0
64,10122,633,163880,164650,770,2,0
65,10122,648,158520,158800,280,1,0
66,10122,652,156730,156860,130,1,0
67,10122,656,3690,3740,50,1,0
68,10122,659,162250,162450,200,2,0
69,10122,662,155100,155260,160,1,0
70,10122,680,4390,5280,890,3,0
71,10122,688,141010,141010,0,2,0
72,10122,694,143850,144290,440,3,0
73,10122,699,2640,2810,170,1,0
74,10122,724,1490,1890,400,1,0
75,10122,744,17040,17950,910,1,180
76,10122,746,145470,146150,680,1,0
77,10122,755,144430,144520,90,1,0
78,10122,757,152830,153510,680,2,0
79,10122,761,2410,2820,410,1,0
80,10122,765,3360,4460,1100,1,0
81,10122,770,127230,127580,350,2,0
82,10122,803,139150,140080,930,1,0
83,10122,809,1980,2060,80,2,0
84,10122,819,249240,249360,120,2,0
85,10122,819,258500,258880,380,2,0
86,10122,821,158090,158810,720,2,0
87,10122,827,173260,174170,910,2,0
88,10122,829,195100,195190,90,1,0
89,10122,846,6350,6420,70,2,0
90,10122,859,152660,153110,450,1,0
91,10122,859,153660,153940,280,1,0
92,10122,862,5300,5460,160,2,0
93,10122,865,160400,160690,290,1,0
94,10122,871,53060,53810,750,1,0
95,10122,872,2310,2370,60,2,0
96,10122,887,158120,158370,250,1,0
97,10122,888,2900,3040,140,1,0
98,10122,895,4860,5010,150,1,0
99,10122,898,3700,4270,570,1,0
100,10122,899,139780,140010,230,1,0
101,10122,899,148560,148750,190,2,0
102,10122,900,2990,3300,310,1,0
103,10122,902,3180,3260,80,1,0
104,10122,915,164170,164280,110,3,0
105,10122,915,172220,172620,400,1,50
106,10122,916,3990,4180,190,2,0
107,10122,925,144320,144400,80,1,0
108,10122,935,214620,215400,780,2,0
109,10122,947,145260,145980,720,1,0
110,10122,965,153440,154500,1060,2,0
111,10122,966,4950,5050,100,1,0
112,10122,972,1240,1830,590,1,0
113,10122,984,6170,6400,230,1,0
114,10122,989,156110,156340,230,2,0
115,10122,989,157380,157500,120,1,0
116,10122,998,1900,2460,560,1,0
117,10122,1000,3170,3920,750,2,0
118,10122,1011,146650,147380,730,4,0
119,10122,1020,179380,179970,590,1,0
120,10122,1034,174280,174370,90,1,0
121,10122,1040,183280,183880,600,1,20
122,10122,1046,17740,17860,120,1,0
123,10122,1049,4370,4470,100,1,0
124,10122,1067,148120,148220,100,2,0
125,10122,1069,149790,149810,20,1,0
126,10122,1070,2730,3510,780,2,0
127,10122,1071,137860,137950,90,2,0
128,10122,1094,147100,147150,50,1,0
129,10122,1120,183380,183400,20,4,0
130,10122,1136,151620,151710,90,2,0
131,10122,1138,185710,185710,0,0,0
132,10122,1301,271910,272220,310,1,0
133,10122,1301,272780,273740,960,1,0
134,10122,1312,154240,154380,140,1,0
135,10122,1316,6410,7490,1080,2,0
136,10122,1325,253080,254160,1080,4,0
137,10122,1329,168180,168200,20,1,0
138,10122,1343,428230,428570,340,1,0
139,10122,1345,143030,143650,620,2,0
140,10122,1346,4890,4890,0,1,0
141,10122,1354,418530,419290,760,2,0
142,10122,1359,199740,200890,1150,5,0
143,10122,1360,6750,6820,70,1,0
144,10122,1366,2310,2520,210,1,0
145,10122,1373,143940,144400,460,2,0
146,10122,1379,520490,520580,90,3,0
147,10122,1395,160040,160180,140,2,0
148,10122,1396,3410,4570,1160,2,0
149,10122,1403,7170,7840,670,1,0
150,10122,1439,157190,157500,310,1,0
151,10122,1461,3240,4010,770,2,0
152,10139,832,81190,81750,560,1,0
153,10139,5020,65420,66010,590,1,0
154,10150,403,32330,32390,60,1,0
155,10150,769,198180,198430,250,1,0
156,10150,769,216720,217440,720,3,0
157,10150,781,191470,191690,220,1,0
158,10150,2300,21760,21980,220,2,0
159,10150,3145,5760,6460,700,1,0
160,10150,4067,51630,51900,270,1,0
161,10150,5584,18440,18550,110,1,0
162,10150,5588,31930,32350,420,1,0
163,10150,5677,19880,20550,670,1,0
164,10155,633,67960,69020,1060,1,0
165,10155,1051,44400,44930,530,2,0
166,10155,1148,10100,10520,420,1,0
167,10160,716,162070,162210,140,1,0
168,10161,989,39250,39820,570,1,0
169,10164,1162,52660,53580,920,1,0
170,10164,2147,66540,66760,220,3,0
171,10165,21,7390,7560,170,1,0
172,10165,30,5050,5180,130,1,0
173,10165,39,11070,11970,900,1,0
174,10165,44,15560,15940,380,1,0
175,10165,45,8910,9230,320,1,0
176,10165,56,3200,3460,260,1,0
177,10165,77,9620,9700,80,1,0
178,10165,84,70860,70940,80,2,0
179,10165,89,62220,62910,690,2,0
180,10165,98,6920,7760,840,2,0
181,10165,135,7370,7450,80,2,0
182,10165,135,8560,8670,110,1,0
183,10165,140,60590,61100,510,1,120
184,10165,188,70330,70590,260,1,0
185,10165,202,78110,79080,970,1,680
186,10165,202,79670,79780,110,1,0
187,10165,236,55660,55700,40,1,0
188,10165,247,9960,10150,190,1,0
189,10165,308,74650,75420,770,1,0
190,10165,334,89480,89570,90,1,0
191,10165,359,75850,76180,330,2,0
192,10165,370,6050,6240,190,1,190
193,10165,378,69490,69590,100,1,0
194,10165,452,59850,60310,460,1,0
195,10165,477,92910,93290,380,1,0
196,10165,481,62170,62710,540,2,30
197,10165,529,213380,214290,910,2,0
198,10165,542,68330,68590,260,1,0
199,10165,568,4410,4630,220,1,150
200,10165,575,7690,7800,110,1,0
201,10165,579,5680,6410,730,2,0
202,10165,599,62080,62440,360,1,0
203,10165,610,13630,13770,140,1,140
204,10165,615,6820,7080,260,2,0
205,10165,649,8300,8570,270,1,0
206,10165,652,100570,100960,390,1,0
207,10165,684,6860,7260,400,1,0
208,10165,689,78770,79090,320,2,0
209,10165,790,83120,83590,470,3,0
210,10165,794,134320,134360,40,3,0
211,10165,794,135020,135180,160,2,0
212,10165,863,117130,117190,60,1,0
213,10165,874,100860,101690,830,2,0
214,10165,908,85620,85710,90,2,0
215,10165,914,134230,134510,280,1,0
216,10165,930,66810,67490,680,2,0
217,10165,970,70130,70350,220,2,0
218,10165,971,51410,51700,290,3,0
219,10165,985,90070,90650,580,1,0
220,10165,985,101000,101000,0,1,0
221,10165,1047,112490,112880,390,1,0
222,10165,1080,116340,116760,420,1,0
223,10165,1081,7030,7170,140,1,0
224,10165,1091,53350,53610,260,1,0
225,10165,1150,102830,103310,480,3,200
226,10165,1185,123870,124930,1060,2,920
227,10165,1187,950,1990,1040,2,850
228,10165,1206,83400,84140,740,2,220
229,10165,1249,97410,97840,430,1,260
230,10165,1292,550,4310,3760,2,2720
231,10165,1292,5090,6050,960,1,110
232,10165,1351,117540,117670,130,2,0
233,10165,1382,117740,117810,70,1,0
234,10165,1410,123090,123250,160,3,0
235,10165,1430,1310,1440,130,1,0
236,10165,1432,164740,164970,230,1,0
237,10165,1433,5480,5770,290,2,0
238,10165,1445,306550,307810,1260,1,0
239,10165,1477,83110,83210,100,1,0
240,10165,1484,123040,123250,210,1,0
241,10165,1485,393900,395190,1290,1,800
242,10165,1485,395850,398270,2420,2,1500
243,10165,1491,162870,163490,620,2,0
244,10165,1526,140880,141500,620,1,0
245,10165,1529,122580,122900,320,2,0
246,10165,1529,145680,145770,90,1,0
247,10165,1540,281280,281390,110,1,0
248,10165,1540,281960,282350,390,2,0
249,10165,1540,300740,300740,0,1,0
250,10165,1544,229200,229700,500,1,450
251,10165,1544,230300,231410,1110,2,800
252,10165,1568,135910,136090,180,1,180
253,10165,1575,97930,98590,660,1,0
254,10165,1579,252230,252530,300,1,0
255,10165,1590,469980,470160,180,3,0
256,10165,1631,135060,135440,380,1,380
257,10165,1631,138840,139610,770,1,400
258,10165,1632,6760,7530,770,1,350
259,10165,1632,9160,9310,150,1,150
260,10165,1643,298360,298870,510,1,510
261,10165,1643,300950,304870,3920,1,2950
262,10204,335,63500,63790,290,2,0
263,10204,1615,45550,45780,230,2,0
264,10569,1821,45480,45780,300,2,0
265,10570,5833,43190,43650,460,1,0
266,10570,6021,40830,41540,710,1,0
267,10570,6021,56110,56440,330,2,0
268,10570,6078,2280,2680,400,2,400
269,10572,44,2250,2830,580,2,0
270,10572,61,105000,105090,90,1,0
271,10572,109,84660,84760,100,1,0
272,10572,183,131000,131390,390,1,0
273,10573,456,117720,118370,650,3,0
274,10573,616,65090,65300,210,2,0
275,10574,1564,13510,14170,660,1,0
276,10574,1564,19750,20570,820,1,120
277,10574,3446,24680,24690,10,1,0
278,10584,29,76450,76550,100,1,0
279,10584,29,77290,77410,120,1,0
280,10584,201,1860,2150,290,1,0
281,10584,238,82310,82560,250,2,0
282,10584,287,52520,52670,150,2,0
283,10584,588,68210,68350,140,2,0
284,10584,801,14560,15120,560,3,0
285,10584,1116,21740,21880,140,1,0
286,10587,894,27380,28200,820,2,0
287,10587,1589,47590,48270,680,2,0
288,10587,1634,34770,35570,800,3,0
289,10587,1812,640,920,280,1,0
290,10587,1873,32440,32560,120,3,0
291,10587,2050,57910,58190,280,2,0
292,10587,2222,21970,22190,220,2,0
293,10587,2222,29200,29670,470,1,0
294,10587,3204,66530,66710,180,3,0
295,10587,4053,31500,31750,250,1,20
296,10587,4053,33860,34210,350,2,0
297,10587,4090,96080,96300,220,1,0
298,10587,4931,1560,1780,220,1,0
299,10605,5561,242430,242710,280,2,0
300,10605,5561,243350,243770,420,3,0
301,10605,5957,108270,108340,70,1,0
302,10605,10316,82490,82540,50,2,0
303,10607,4687,9670,9960,290,2,0
304,10607,5916,139230,139580,350,1,0
305,10607,5933,186620,186800,180,1,0
306,10616,977,29830,29880,50,1,0
307,10616,978,24710,25290,580,3,0
308,10616,1833,198990,199960,970,2,0
309,10618,17,74050,74330,280,1,150
310,10618,56,10730,11400,670,1,0
311,10618,56,104310,104310,0,2,0
312,10618,56,106750,106980,230,1,0
313,10618,69,57210,58040,830,1,150
314,10618,77,66040,66510,470,1,0
315,10618,112,100440,100630,190,1,0
316,10618,113,8840,9400,560,2,0
317,10618,113,153270,153350,80,1,0
318,10618,113,154370,154550,180,1,0
319,10618,122,146470,146600,130,2,0
320,10618,125,70020,70150,130,2,0
321,10618,125,70980,71280,300,1,0
322,10618,146,16870,17390,520,1,0
323,10618,159,6090,6470,380,3,0
324,10618,160,82400,82490,90,2,0
325,10618,168,126490,126570,80,1,0
326,10618,185,149230,149270,40,1,0
327,10618,212,8560,8940,380,1,0
328,10618,222,71330,72110,780,1,780
329,10618,227,6750,7140,390,1,0
330,10618,252,92150,92240,90,4,0
331,10618,275,5870,7240,1370,3,850
332,10618,276,20230,20270,40,1,0
333,10618,276,21490,22370,880,4,0
334,10618,289,139020,139170,150,2,0
335,10618,301,147090,147250,160,2,0
336,10618,315,6420,6490,70,1,0
337,10618,315,52930,53250,320,1,0
338,10618,336,75590,75800,210,1,0
339,10618,337,123950,123990,40,1,0
340,10618,338,4090,4310,220,1,0
341,10618,373,4460,4490,30,2,0
342,10618,379,3310,3630,320,1,0
343,10618,387,107390,107390,0,1,0
344,10618,387,108360,108580,220,2,0
345,10618,388,2160,2470,310,1,0
346,10618,395,5080,5220,140,1,0
347,10618,427,81890,81990,100,1,0
348,10618,443,64180,64900,720,2,230
349,10618,445,6380,6880,500,3,0
350,10618,449,8640,8770,130,3,0
351,10618,452,10900,11000,100,2,0
352,10618,458,91380,91560,180,1,0
353,10618,458,92740,92780,40,1,0
354,10618,458,109310,109470,160,2,0
355,10618,459,6080,6610,530,1,0
356,10618,461,130250,130440,190,2,0
357,10618,465,165060,165290,230,1,0
358,10618,488,6470,6550,80,3,0
359,10618,493,143420,143500,80,1,0
360,10618,504,39170,39660,490,1,280
361,10618,511,82630,82940,310,2,0
362,10618,512,8920,9030,110,2,0
363,10618,515,12770,13090,320,1,0
364,10618,515,18150,18210,60,1,0
365,10618,522,107420,107440,20,1,0
366,10618,522,108600,108740,140,1,0
367,10618,565,8240,8520,280,2,0
368,10618,566,345800,346000,200,1,0
369,10618,572,109650,109740,90,1,0
370,10618,589,4500,4670,170,1,0
371,10618,606,4590,4990,400,2,0
372,10618,630,178560,178810,250,1,0
373,10618,644,103290,103360,70,1,0
374,10618,644,104550,104750,200,1,0
375,10618,645,11510,11650,140,2,0
376,10618,645,12410,12730,320,1,0
377,10618,649,123660,124330,670,2,0
378,10618,650,8060,8920,860,1,0
379,10618,660,8770,8980,210,3,0
380,10618,665,148990,149320,330,1,0
381,10618,673,28840,29290,450,4,0
382,10618,701,107280,107510,230,2,0
383,10618,713,576500,577060,560,2,0
384,10618,713,578650,578990,340,2,0
385,10618,728,193580,193870,290,2,0
386,10618,732,10920,11330,410,1,0
387,10618,737,7590,7980,390,2,0
388,10618,742,221590,221660,70,1,0
389,10618,753,107520,107870,350,1,0
390,10618,753,108580,109220,640,1,0
391,10618,754,6000,6520,520,3,0
392,10618,756,195480,195620,140,1,0
393,10618,779,119300,119610,310,1,0
394,10618,782,29480,29750,270,2,0
395,10618,782,31640,32190,550,1,0
396,10618,811,6620,7060,440,1,0
397,10618,811,7720,8100,380,1,0
398,10618,819,131500,131510,10,1,0
399,10618,819,132500,132630,130,1,0
400,10618,820,8710,9260,550,5,0
401,10618,857,3860,3860,0,2,0
402,10618,875,215950,216370,420,2,0
403,10618,895,5570,5680,110,1,110
404,10618,906,73040,73300,260,1,0
405,10618,939,185150,185460,310,1,0
406,10618,944,5990,6420,430,4,0
407,10618,948,126220,126680,460,2,0
408,10618,952,7610,7670,60,1,0
409,10618,978,4410,4620,210,2,0
410,10618,979,218220,218310,90,1,0
411,10618,991,5340,5680,340,2,0
412,10618,1027,12660,13050,390,3,0
413,10618,1033,3790,3950,160,2,0
414,10618,1033,15890,16160,270,1,0
415,10618,1038,129390,129650,260,1,0
416,10618,1039,35790,36270,480,2,0
417,10618,1042,94200,94330,130,1,0
418,10618,1046,156010,156180,170,2,0
419,10618,1049,149710,150100,390,2,0
420,10618,1051,156460,157090,630,2,0
421,10618,1059,5450,5550,100,1,0
422,10618,1067,89580,89820,240,1,0
423,10618,1089,4300,4540,240,1,0
424,10618,1092,107260,107420,160,1,0
425,10618,1098,4720,4850,130,1,0
426,10618,1100,9210,9360,150,1,0
427,10618,1118,16050,16210,160,1,0
428,10618,1127,22450,23180,730,1,0
429,10618,1134,51280,51280,0,1,0
430,10618,1135,4050,4370,320,1,0
431,10618,1148,5630,5860,230,1,0
432,10618,1148,6890,7220,330,3,0
433,10618,1164,193430,194340,910,3,230
434,10618,1173,31080,31270,190,3,0
435,10618,1176,5960,6300,340,3,0
436,10618,1190,25480,25870,390,3,0
437,10618,1190,42090,42200,110,1,0
438,10618,1190,48540,48880,340,1,0
439,10618,1190,52520,52650,130,1,0
440,10618,1198,56140,56600,460,1,0
441,10618,1223,166960,167080,120,1,0
442,10618,1239,147820,148010,190,1,0
443,10618,1257,4510,4730,220,3,0
444,10618,1271,15240,15340,100,1,0
445,10618,1288,81570,82120,550,1,0
446,10618,1289,7960,8150,190,1,0
447,10618,1297,6400,6600,200,1,0
448,10618,1302,3780,4010,230,1,0
449,10618,1305,108330,108340,10,2,0
450,10618,1314,4310,4840,530,3,0
451,10618,1319,122230,122390,160,2,0
452,10618,1320,6480,6640,160,1,0
453,10618,1320,172950,173580,630,3,0
454,10618,1330,4330,4520,190,2,0
455,10618,1335,11150,12210,1060,2,160
456,10618,1335,15350,15860,510,2,0
457,10618,1339,4960,5290,330,1,0
458,10618,1344,136370,136410,40,1,0
459,10618,1348,26990,27590,600,2,0
460,10618,1349,6060,6330,270,1,0
461,10618,1362,100560,100970,410,1,0
462,10618,1375,55160,55400,240,2,0
463,10618,1376,7470,7540,70,1,0
464,10618,1381,4770,4970,200,2,0
465,10618,1381,19690,19880,190,2,0
466,10618,1381,67430,67550,120,3,0
467,10618,1387,118290,118370,80,1,0
468,10618,1387,119790,119880,90,2,0
469,10618,1395,5070,5460,390,1,0
470,10618,1433,59540,59580,40,1,0
471,10618,1436,8580,8690,110,2,0
472,10618,1483,181070,181290,220,1,0
473,10618,1490,20740,21240,500,1,0
474,10618,1490,21990,22170,180,1,0
475,10618,1495,102550,102600,50,1,0
476,10618,1518,98000,98670,670,2,0
477,10618,1519,8610,8720,110,1,0
478,10618,1521,147580,148160,580,1,0
479,10618,1531,93590,93970,380,1,0
480,10618,1532,7660,7750,90,2,0
481,10618,1553,210350,210640,290,1,0
482,10618,1553,211650,211980,330,1,0
483,10618,1554,6970,7100,130,2,0
484,10618,1563,170630,170940,310,1,0
485,10618,1568,140170,141200,1030,1,460
486,10618,1581,173450,173530,80,1,0
487,10620,4453,4390,4390,0,1,0
488,13103,9590,137220,139040,1820,1,1820
489,13103,15481,32760,32870,110,1,0
490,13103,18194,56410,56500,90,2,0
491,13103,18194,59940,60270,330,1,0
492,13103,18559,14740,15010,270,1,0
493,13105,16768,110220,110660,440,1,0
494,13105,19247,13220,13740,520,1,0
495,13105,20209,13550,13790,240,1,0
496,13105,20527,9390,9620,230,1,0
497,13105,20899,64330,64350,20,1,0
498,13107,165,15380,15660,280,1,0
499,13107,3507,4640,4820,180,1,40
500,13107,3562,40300,40670,370,1,0
501,13107,3562,41780,41880,100,1,0
502,13107,3727,33880,34060,180,1,0
503,13107,3778,35610,36400,790,1,0
504,13107,3972,61220,62570,1350,3,0
505,13107,4074,5560,6140,580,1,0
506,13107,4195,45030,46330,1300,1,0
507,13107,4351,36700,37040,340,1,0
508,13107,4352,9880,10100,220,1,0
509,13107,4458,36580,36700,120,1,0
510,13107,4459,6940,7160,220,1,0
511,13107,4584,25070,25590,520,1,0
512,13107,4585,6040,6280,240,1,0
513,13107,4729,4310,4490,180,2,0
514,13107,5190,119450,122590,3140,1,3140
515,13107,5262,3650,4240,590,2,0
516,13107,5309,45220,45780,560,3,0
517,13107,5516,107110,107610,500,1,0
518,13107,5590,112070,112170,100,1,0
519,13107,5701,45160,45830,670,1,0
520,13107,5922,1930,3230,1300,2,0
521,13107,6037,28130,28380,250,2,0
522,13107,6037,29850,30250,400,2,0
523,13107,6263,47640,47800,160,1,0
524,13107,6376,60310,60890,580,2,0
525,13107,6377,10560,11330,770,3,0
526,13107,6490,42510,42750,240,1,0
527,13107,6589,49680,50000,320,2,0
528,13107,6589,50720,51990,1270,1,440
529,13107,6633,8600,8880,280,2,0
530,13107,7060,11500,11890,390,1,0
531,13107,7397,52610,54750,2140,1,2140
532,13107,7502,111750,112380,630,2,0
533,13107,7502,113170,113430,260,1,210
534,13107,7802,60920,61430,510,2,0
535,13107,8007,49910,50170,260,1,0
536,13107,8306,33630,33750,120,1,0
537,13107,8414,30170,32150,1980,2,0
538,13107,8514,30820,30820,0,1,0
539,13107,9578,3310,3390,80,1,0
540,13107,9903,46020,46230,210,1,0
541,13107,9904,1290,1420,130,1,0
542,13107,10155,760,1320,560,1,470
543,13107,10583,32450,32510,60,1,0
544,13107,10887,55900,56110,210,1,0
545,13107,10888,1320,1510,190,1,0
546,13107,11176,34710,35880,1170,1,0
547,13107,11329,21570,22940,1370,2,0
548,13107,11390,50250,51230,980,1,980
549,13107,11925,20370,20840,470,1,0
550,13107,12030,2490,3220,730,1,640
551,13107,12030,5470,5760,290,2,0
552,13107,12049,61570,61700,130,2,0
553,13107,12093,22240,23000,760,2,0
554,13107,12175,27590,27750,160,1,0
555,13107,12175,28300,28480,180,1,0
556,13107,12175,29410,29920,510,2,0
557,13107,12249,34810,36010,1200,1,0
558,13107,12266,73530,73650,120,2,0
559,13107,12364,28280,29200,920,2,0
560,13107,12502,37860,38500,640,1,250
561,13107,13661,21620,22550,930,1,0
562,13107,15042,27720,27810,90,2,0
563,13107,16011,37070,37490,420,1,0
564,13107,16012,15610,16750,1140,3,220
565,13108,972,18990,18990,0,1,0
566,13108,1121,94320,94700,380,2,0
567,13108,1187,88580,88840,260,1,0
568,13108,1457,144610,145220,610,1,0
569,13108,8641,94100,94220,120,1,0
570,13108,11206,48060,49430,1370,2,0
571,13109,12219,17040,17160,120,3,0
572,13109,12439,15660,15780,120,1,0
573,13109,12807,14480,14780,300,1,0
574,13110,4709,62940,63080,140,2,0
575,13110,15259,14790,15340,550,1,0
576,13110,15259,15940,17480,1540,2,0
577,13110,15259,20640,21120,480,2,0
578,13110,15363,10770,11910,1140,3,0
579,17101,609,92100,92500,400,1,0
580,17101,1052,202630,202630,0,3,0
581,17101,1052,328980,328980,0,2,0
582,17101,1175,80210,80500,290,1,0
583,17101,1201,94870,95110,240,3,0
584,17101,1213,76770,76860,90,1,0
585,17101,1213,248380,248580,200,1,0
586,17101,2144,112130,112550,420,2,0
587,17102,1607,429640,429650,10,1,0
