Event,Device,Trip,Starttime,Endtime,Duration,Pedestrians,Stoptime
1,10122,155,144760,144810,50,1,0
2,10122,202,148050,148150,100,2,0
3,10122,202,148970,149290,320,2,0
4,10122,242,157450,157630,180,1,0
5,10122,255,171000,171160,160,1,0
6,10122,278,202090,202260,170,3,0
7,10122,285,134320,134400,80,1,0
8,10122,289,18790,19520,730,2,260
9,10122,289,20730,20840,110,1,0
10,10122,289,34170,34430,260,1,0
11,10122,291,480630,480780,150,3,0
12,10122,292,52390,52980,590,1,0
13,10122,295,149140,149510,370,3,0
14,10122,305,160210,160430,220,1,0
15,10122,312,141280,144260,2980,2,480
16,10122,317,148190,148390,200,1,0
17,10122,318,5010,5140,130,1,0
18,10122,331,90360,90420,60,3,0
19,10122,337,220880,221430,550,4,0
20,10122,342,1920,2150,230,1,0
21,10122,347,168720,168930,210,1,0
22,10122,351,153050,153890,840,3,60
23,10122,352,3140,3430,290,2,0
24,10122,354,173640,173770,130,2,0
25,10122,357,135800,136040,240,4,0
26,10122,370,161340,161430,90,1,0
27,10122,371,6070,6160,90,1,0
28,10122,387,6090,6220,130,1,0
29,10122,403,158750,158870,120,3,0
30,10122,409,135150,135410,260,2,0
31,10122,410,290,520,230,2,0
32,10122,416,4580,4710,130,1,0
33,10122,425,154680,154770,90,3,0
34,10122,430,181570,181690,120,2,0
35,10122,432,173070,173130,60,2,0
36,10122,433,3040,3580,540,2,0
37,10122,438,2430,2570,140,2,0
38,10122,446,195350,195490,140,2,0
39,10122,447,8660,8740,80,1,0
40,10122,449,5090,5220,130,1,0
41,10122,454,8750,8930,180,1,0
42,10122,456,82900,83020,120,1,0
43,10122,457,1880,2210,330,1,0
44,10122,459,147370,147880,510,2,0
45,10122,469,2020,2150,130,1,0
46,10122,472,3440,3450,10,1,0
47,10122,476,6260,6440,180,1,0
48,10122,479,8680,8770,90,2,0
49,10122,496,2820,3390,570,1,560
50,10122,499,142510,143110,600,2,0
51,10122,500,2540,2620,80,1,0
52,10122,505,137730,137870,140,2,0
53,10122,515,1910,1910,0,1,0
54,10122,544,144810,145040,230,2,0
55,10122,545,3680,3760,80,1,0
56,10122,551,3930,4020,90,3,0
57,10122,555,66950,67080,130,1,0
58,10122,577,151130,151380,250,2,0
59,10122,578,2680,2820,140,1,0
60,10122,586,13860,14030,170,2,0
61,10122,589,123660,124300,640,2,30
62,10122,604,7440,7630,190,1,0
63,10122,607,160700,160770,70,3,0
64,10122,612,163330,163350,20,2,0
65,10122,622,157950,158260,310,2,0
66,10122,623,2210,2510,300,2,0
67,10122,634,7050,7090,40,1,0
68,10122,646,6880,7110,230,2,0
69,10122,648,158980,159250,270,1,0
70,10122,649,2970,3150,180,1,0
71,10122,650,154170,154310,140,3,0
72,10122,655,153930,154160,230,2,0
73,10122,662,155520,155630,110,2,0
74,10122,665,143780,144070,290,1,0
75,10122,668,7380,7410,30,2,0
76,10122,668,8060,8160,100,1,0
77,10122,680,3470,3570,100,1,0
78,10122,683,2660,2790,130,1,0
79,10122,687,3150,3250,100,1,0
80,10122,699,1760,1920,160,1,0
81,10122,702,1100,1370,270,1,0
82,10122,704,151670,151920,250,1,0
83,10122,723,182920,182930,10,2,0
84,10122,742,5070,5410,340,1,0
85,10122,744,11120,11310,190,2,0
86,10122,744,15710,15760,50,1,0
87,10122,747,1560,1640,80,2,0
88,10122,760,148090,148170,80,1,0
89,10122,778,151660,152020,360,4,0
90,10122,798,1550,1750,200,1,0
91,10122,801,171210,171450,240,1,0
92,10122,809,1640,1750,110,1,0
93,10122,817,1180,1270,90,1,0
94,10122,822,3060,3090,30,1,0
95,10122,862,3810,4610,800,1,330
96,10122,865,161940,162260,320,2,0
97,10122,866,3360,3490,130,1,0
98,10122,871,61080,61200,120,2,0
99,10122,878,9450,9560,110,1,0
100,10122,887,159520,159670,150,2,0
101,10122,895,4500,4650,150,1,0
102,10122,902,2690,2880,190,1,0
103,10122,915,164500,164660,160,4,0
104,10122,922,47080,47150,70,1,0
105,10122,946,4720,4720,0,1,0
106,10122,961,157430,157660,230,1,0
107,10122,971,115830,116080,250,1,0
108,10122,972,320,920,600,2,0
109,10122,983,201590,201710,120,1,0
110,10122,988,5760,5930,170,1,0
111,10122,989,157700,157800,100,1,0
112,10122,990,2190,2570,380,3,0
113,10122,998,1420,1490,70,1,0
114,10122,999,42880,43110,230,2,0
115,10122,1006,150840,151650,810,3,190
116,10122,1011,148240,148330,90,1,0
117,10122,1020,180770,180980,210,3,0
118,10122,1024,3640,3760,120,1,0
119,10122,1034,174760,175020,260,1,0
120,10122,1040,185260,185580,320,3,0
121,10122,1043,159210,159540,330,2,0
122,10122,1069,150000,150230,230,2,0
123,10122,1077,162980,163970,990,3,810
124,10122,1086,3500,3720,220,2,0
125,10122,1094,147800,147910,110,1,0
126,10122,1097,2990,3140,150,1,0
127,10122,1118,205470,205590,120,3,0
128,10122,1120,183600,183800,200,3,0
129,10122,1123,85690,85780,90,1,0
130,10122,1126,52900,53010,110,1,0
131,10122,1136,159210,159270,60,1,0
132,10122,1138,185950,186020,70,1,0
133,10122,1138,186680,187210,530,3,250
134,10122,1142,176940,177320,380,2,0
135,10122,1298,1660,1680,20,1,0
136,10122,1304,250180,250190,10,1,0
137,10122,1312,146190,146440,250,2,0
138,10122,1316,5620,5760,140,1,0
139,10122,1318,169130,169560,430,2,0
140,10122,1339,206550,206960,410,3,0
141,10122,1343,429970,430350,380,2,0
142,10122,1345,143840,143900,60,1,0
143,10122,1354,421020,421170,150,2,0
144,10122,1361,171800,171950,150,2,0
145,10122,1366,1910,2100,190,1,0
146,10122,1373,133150,133170,20,2,0
147,10122,1379,517410,517600,190,1,0
148,10122,1381,466410,466740,330,2,0
149,10122,1381,475450,476880,1430,3,370
150,10122,1381,477560,477860,300,4,70
151,10122,1382,1080,1090,10,2,0
152,10122,1385,6420,6560,140,1,0
153,10122,1395,160500,161480,980,2,120
154,10122,1396,2730,3200,470,1,0
155,10122,1397,33710,34000,290,1,0
156,10122,1397,45060,45320,260,1,0
157,10122,1408,152470,152640,170,1,0
158,10122,1409,5970,6170,200,2,0
159,10122,1410,163670,163970,300,1,0
160,10122,1411,1620,1930,310,1,0
161,10122,1412,153990,154150,160,2,0
162,10122,1413,11110,11500,390,2,0
163,10122,1430,196700,198550,1850,2,220
164,10122,1433,144920,145480,560,3,130
165,10122,1437,174680,175380,700,2,200
166,10122,1439,159070,159220,150,2,0
167,10122,1440,380,610,230,3,0
168,10122,1461,2740,3020,280,2,0
169,10122,1463,183460,183500,40,3,0
170,10129,414,27440,27810,370,3,0
171,10137,1247,4490,4530,40,2,0
172,10139,782,72400,73020,620,3,0
173,10139,5020,68450,69010,560,1,410
174,10139,7138,91200,91330,130,3,0
175,10139,7138,91910,92020,110,2,0
176,10141,748,185300,185360,60,1,0
177,10141,748,189930,190650,720,5,0
178,10150,366,82270,82400,130,2,0
179,10150,403,32590,32610,20,2,0
180,10150,769,201070,201670,600,1,570
181,10150,769,214530,214670,140,2,0
182,10150,781,191900,191970,70,2,0
183,10150,781,196210,196510,300,2,240
184,10150,781,199610,200140,530,2,0
185,10150,781,200960,201150,190,2,0
186,10150,781,202430,202660,230,1,0
187,10150,2300,22230,22480,250,5,0
188,10150,2300,23230,23620,390,3,0
189,10150,4039,16090,16490,400,4,0
190,10150,4039,17980,18060,80,1,0
191,10155,659,55820,57370,1550,4,0
192,10160,710,117420,117630,210,2,0
193,10160,710,126000,126130,130,1,0
194,10161,989,40910,41070,160,2,0
195,10161,2166,71060,71170,110,1,0
196,10161,2168,48820,50270,1450,3,0
197,10164,186,56150,56390,240,2,0
198,10164,931,54190,54590,400,1,0
199,10165,908,84490,85310,820,3,0
200,10165,930,68160,68350,190,1,0
201,10165,930,73200,73510,310,2,310
202,10165,930,98470,99420,950,1,930
203,10165,930,100170,101710,1540,1,1540
204,10165,930,108170,108430,260,5,0
205,10165,963,71170,71440,270,6,0
206,10165,963,72140,73050,910,2,770
207,10165,966,121740,125030,3290,1,1970
208,10165,983,103720,104200,480,1,0
209,10165,983,175750,176800,1050,2,600
210,10165,983,189930,190880,950,2,930
211,10165,985,98030,98590,560,1,0
212,10165,985,100790,100850,60,1,0
213,10165,1047,111750,112090,340,1,0
214,10165,1145,95280,95970,690,2,130
215,10165,1145,96790,96910,120,2,0
216,10165,1239,114340,114770,430,1,430
217,10165,1239,115360,115450,90,1,90
218,10165,1239,116080,116810,730,1,730
219,10165,1239,118720,129490,10770,2,10020
220,10165,1239,134260,134400,140,3,0
221,10165,1351,102250,102520,270,2,0
222,10165,1351,103090,103480,390,1,0
223,10165,1351,108950,113880,4930,1,4770
224,10165,1351,114550,114630,80,1,0
225,10165,1382,88960,89310,350,1,0
226,10165,1411,4730,5410,680,3,0
227,10165,1427,170740,171060,320,1,0
228,10165,1429,96640,97340,700,2,0
229,10165,1468,185620,185860,240,2,0
230,10165,1472,84820,85330,510,4,0
231,10165,1477,82900,82940,40,1,0
232,10165,1479,122630,123070,440,2,0
233,10165,1484,92870,93380,510,2,0
234,10165,1491,161590,162050,460,3,0
235,10165,1540,295430,296390,960,1,0
236,10165,1547,301520,302280,760,1,0
237,10165,1548,199100,199380,280,2,0
238,10204,335,64030,64590,560,2,0
239,10204,1525,272210,272950,740,1,0
240,10204,1530,55190,59310,4120,3,2320
241,10204,1530,66540,67930,1390,1,830
242,10204,1530,75690,75780,90,1,0
243,10204,1615,7760,7830,70,1,0
244,10204,1615,11860,12610,750,3,0
245,10204,1615,36570,36760,190,1,0
246,10205,953,16430,16810,380,1,0
247,10205,1266,57320,57550,230,2,0
248,10205,1540,57180,57830,650,4,0
249,10205,1654,80350,80350,0,2,0
250,10205,1689,10560,11310,750,1,0
251,10205,1689,11830,12180,350,1,0
252,10205,1689,69530,70480,950,3,760
253,10205,1689,77090,77290,200,1,0
254,10222,352,138850,139170,320,1,0
255,10222,3099,1200,1420,220,1,0
256,10502,1339,67980,68190,210,2,0
257,10502,1465,66200,66220,20,2,0
258,10502,1534,14170,14550,380,1,0
259,10502,1534,17990,18600,610,2,0
260,10502,1675,8940,8940,0,1,0
261,10502,1787,60980,62110,1130,3,0
262,10502,1901,11020,11960,940,2,0
263,10510,471,49910,50090,180,2,0
264,10510,471,50940,51510,570,2,0
265,10510,2934,39760,39910,150,1,0
266,10510,2935,60490,60780,290,1,0
267,10557,1971,184770,184860,90,2,0
268,10557,1971,185790,185920,130,2,0
269,10557,1971,190670,191930,1260,2,1250
270,10557,1971,193370,194730,1360,3,760
271,10557,1971,195350,199840,4490,2,4140
272,10557,1971,201870,202900,1030,2,880
273,10557,1971,207510,208530,1020,2,1020
274,10557,1971,215460,219230,3770,3,2670
275,10557,1971,219910,222390,2480,2,2360
276,10557,1981,86010,86140,130,3,0
277,10557,1982,219430,219900,470,1,470
278,10557,1982,237800,237880,80,2,80
279,10557,1982,240830,241550,720,2,160
280,10557,1982,243970,244840,870,1,520
281,10557,1982,246440,246720,280,2,0
282,10557,1986,36740,37990,1250,1,1180
283,10557,1986,53210,53640,430,2,420
284,10557,1986,54680,55230,550,1,550
285,10557,1986,61050,63470,2420,1,1290
286,10557,1986,64860,65680,820,1,820
287,10557,1986,70810,70900,90,1,90
288,10557,1986,72140,73240,1100,1,1100
289,10557,1986,73830,75140,1310,1,1310
290,10557,1986,75790,75960,170,1,170
291,10557,1986,76810,77920,1110,1,1100
292,10557,1991,55290,56360,1070,1,0
293,10557,1991,78670,78760,90,1,90
294,10557,1991,81870,82030,160,1,20
295,10557,1991,84430,85010,580,1,580
296,10557,1991,86090,86280,190,1,190
297,10557,1991,89700,90220,520,1,520
298,10557,2070,179120,179690,570,1,0
299,10569,1821,45950,46990,1040,4,0
300,10570,6021,56710,57220,510,2,0
301,10572,26,2320,2550,230,1,0
302,10572,27,82360,82470,110,1,0
303,10572,28,3530,3550,20,1,0
304,10572,48,95870,95990,120,2,0
305,10572,98,80210,80330,120,1,0
306,10572,107,105070,105180,110,2,0
307,10572,109,83140,83690,550,1,0
308,10572,146,85760,85790,30,1,0
309,10572,161,82670,82790,120,1,0
310,10572,173,111890,112100,210,1,0
311,10572,183,124210,124310,100,1,0
312,10572,185,135330,135570,240,2,0
313,10572,206,89720,89770,50,1,0
314,10572,208,89920,90050,130,1,0
315,10572,215,87820,88060,240,2,0
316,10572,221,1040,1370,330,2,0
317,10573,616,66400,67270,870,2,0
318,10574,1564,12580,12760,180,2,0
319,10574,2369,6710,6820,110,2,0
320,10574,3446,24930,25220,290,1,0
321,10584,24,30260,30400,140,2,0
322,10584,29,84530,84640,110,2,0
323,10584,46,36100,37480,1380,3,0
324,10584,48,32780,32960,180,1,0
325,10584,51,40990,41280,290,2,0
326,10584,76,36320,36440,120,1,0
327,10584,89,29550,29870,320,2,0
328,10584,89,32530,32630,100,1,0
329,10584,92,30500,30690,190,2,0
330,10584,121,27350,27490,140,1,0
331,10584,125,32160,32440,280,2,0
332,10584,125,33050,33430,380,2,0
333,10584,127,31940,32730,790,3,0
334,10584,130,26730,27150,420,1,0
335,10584,153,28660,29200,540,1,0
336,10584,159,28210,28860,650,2,0
337,10584,159,29900,30030,130,1,0
338,10584,165,56660,56850,190,1,0
339,10584,179,38080,38570,490,2,80
340,10584,179,39820,39930,110,2,0
341,10584,181,29960,30120,160,2,0
342,10584,184,32420,32570,150,1,0
343,10584,198,30490,31010,520,1,0
344,10584,202,26270,27960,1690,1,0
345,10584,203,11310,11860,550,2,120
346,10584,203,13340,14400,1060,2,0
347,10584,208,28500,29150,650,1,0
348,10584,210,3360,3520,160,2,110
349,10584,212,64600,64710,110,2,0
350,10584,214,30960,32280,1320,1,0
351,10584,229,28510,28740,230,3,0
352,10584,229,29410,29570,160,1,0
353,10584,235,27000,27820,820,3,0
354,10584,235,28830,29330,500,3,0
355,10584,238,82780,82790,10,4,0
356,10584,243,35840,37350,1510,2,0
357,10584,266,28450,28650,200,1,0
358,10584,279,28090,28190,100,2,0
359,10584,282,32150,32270,120,1,0
360,10584,285,28490,28610,120,2,0
361,10584,288,2040,2270,230,2,0
362,10584,310,24890,25540,650,2,0
363,10584,311,8180,8360,180,2,180
364,10584,311,13530,14850,1320,2,1110
365,10584,319,32080,32600,520,1,150
366,10584,325,28910,29130,220,1,0
367,10584,325,30260,30430,170,1,0
368,10584,327,33300,33820,520,1,0
369,10584,356,34700,34920,220,1,0
370,10584,400,32930,33050,120,1,0
371,10584,402,34740,34830,90,1,0
372,10584,422,6990,7200,210,3,0
373,10584,425,30350,30920,570,2,0
374,10584,425,31590,31800,210,1,0
375,10584,457,43710,43810,100,1,0
376,10584,457,45310,45440,130,1,30
377,10584,472,26750,26840,90,1,0
378,10584,472,27660,27750,90,2,0
379,10584,482,25260,26230,970,2,0
380,10584,484,38280,38430,150,2,0
381,10584,487,29430,29770,340,1,0
382,10584,493,27070,27410,340,4,0
383,10584,591,32460,32980,520,1,0
384,10584,593,49790,50220,430,1,0
385,10584,612,28730,29000,270,3,0
386,10584,617,28630,28770,140,1,0
387,10584,625,66880,67840,960,3,0
388,10584,625,68420,68520,100,1,0
389,10584,625,69590,71610,2020,1,2020
390,10584,639,36280,36820,540,1,0
391,10584,644,21800,22270,470,2,0
392,10584,650,33990,35840,1850,3,640
393,10584,650,36540,36880,340,1,0
394,10584,650,38440,38520,80,2,80
395,10584,652,54000,54870,870,2,0
396,10584,676,29560,29780,220,1,0
397,10584,678,30670,30940,270,1,0
398,10584,680,28710,28830,120,1,0
399,10584,680,35160,35790,630,1,630
400,10584,711,31440,32060,620,1,0
401,10584,737,31710,31870,160,1,0
402,10584,765,32670,34620,1950,4,0
403,10584,765,35630,36370,740,1,690
404,10584,768,31290,31830,540,1,0
405,10584,772,29940,30770,830,1,0
406,10584,780,28430,29730,1300,3,0
407,10584,782,32290,32860,570,2,0
408,10584,791,54560,54680,120,1,0
409,10584,797,11540,11770,230,1,0
410,10584,797,14850,15420,570,1,530
411,10584,801,15350,15360,10,1,0
412,10584,823,33240,33260,20,2,0
413,10584,830,29730,30880,1150,4,0
414,10584,830,32050,32330,280,1,0
415,10584,832,33810,34400,590,1,0
416,10584,862,34830,35410,580,2,580
417,10584,866,34930,35270,340,1,0
418,10584,871,27870,28320,450,2,0
419,10584,873,43890,44010,120,1,0
420,10584,878,27620,27720,100,1,0
421,10584,885,32300,34090,1790,4,0
422,10584,893,29560,29930,370,1,0
423,10584,895,30400,30820,420,2,0
424,10584,895,31350,31440,90,1,0
425,10584,918,29440,29530,90,1,0
426,10584,920,31690,31870,180,1,0
427,10584,925,93950,94130,180,1,0
428,10584,930,38540,38630,90,1,0
429,10584,933,26520,26730,210,2,0
430,10584,953,26610,26940,330,1,0
431,10584,957,29920,30860,940,1,0
432,10584,957,31440,31770,330,1,0
433,10584,960,29020,29050,30,2,0
434,10584,960,29840,32040,2200,2,460
435,10584,960,32560,32780,220,1,220
436,10584,980,18890,19000,110,1,0
437,10584,982,30120,30320,200,1,0
438,10584,985,24960,25860,900,2,0
439,10584,987,28900,30140,1240,2,0
440,10584,1008,28920,29180,260,2,0
441,10584,1010,28510,28650,140,1,0
442,10584,1010,36370,37090,720,3,710
443,10584,1026,28120,28860,740,1,0
444,10584,1029,29710,30690,980,2,0
445,10584,1033,28820,29730,910,2,0
446,10584,1043,1530,1620,90,1,0
447,10584,1076,29990,31480,1490,3,260
448,10584,1080,27990,29340,1350,2,0
449,10584,1111,28920,29110,190,1,0
450,10584,1111,29710,29820,110,1,0
451,10584,1116,22090,22230,140,1,0
452,10584,1132,26940,27240,300,4,0
453,10584,1137,11380,12540,1160,1,0
454,10584,1144,27990,28610,620,2,0
455,10587,323,15800,16140,340,1,0
456,10587,894,28940,29050,110,1,0
457,10587,1589,48690,48960,270,1,0
458,10587,1620,109950,110160,210,2,0
459,10587,1634,35770,35780,10,3,0
460,10587,1695,45360,45600,240,1,0
461,10587,1695,50430,50540,110,4,0
462,10587,1871,53880,53980,100,1,0
463,10587,1873,34540,35170,630,4,350
464,10587,2050,58440,58440,0,2,0
465,10587,2050,87950,88520,570,1,570
466,10587,2050,89370,89940,570,1,570
467,10587,2050,93700,94080,380,2,0
468,10587,2077,46570,46600,30,2,0
469,10587,2089,29750,31650,1900,1,1530
470,10587,2089,33320,33930,610,2,0
471,10587,2090,27340,27340,0,3,0
472,10587,2221,144580,144800,220,3,0
473,10587,2221,145420,145880,460,3,330
474,10587,2221,147390,147730,340,2,200
475,10587,2221,149760,149970,210,3,0
476,10587,2222,28480,28520,40,1,0
477,10587,2317,2710,2850,140,2,0
478,10587,2380,54780,54820,40,1,0
479,10587,2381,3190,3370,180,3,0
480,10587,2476,22750,22840,90,3,0
481,10587,2478,32690,33080,390,1,0
482,10587,2482,23160,23220,60,3,0
483,10587,2482,28010,28190,180,3,0
484,10587,2482,28710,29200,490,5,270
485,10587,2533,30670,30970,300,1,0
486,10587,2533,35080,35170,90,1,0
487,10587,2533,38220,38340,120,1,120
488,10587,3040,29130,29130,0,2,0
489,10587,3040,29790,29870,80,1,0
490,10587,3205,2250,2850,600,2,0
491,10587,3285,69050,70310,1260,2,1220
492,10587,3285,71490,71650,160,2,0
493,10587,3301,46410,46520,110,3,0
494,10587,3432,1120,1650,530,3,0
495,10587,3541,59320,60510,1190,1,610
496,10587,3988,70620,70750,130,1,0
497,10587,3989,8590,8790,200,1,0
498,10587,4053,7240,8470,1230,1,0
499,10587,4053,9150,9250,100,1,0
500,10587,4053,10020,10730,710,3,540
501,10587,4053,14460,14770,310,2,0
502,10587,4146,2950,3170,220,1,0
503,10587,4712,1260,1350,90,1,0
504,10587,5282,1360,1400,40,1,0
505,10593,791,23070,23160,90,3,0
506,10593,791,25590,26840,1250,4,0
507,10593,791,28530,28640,110,1,0
508,10593,815,21350,21750,400,1,0
509,10593,815,30020,31820,1800,2,0
510,10593,815,33360,33440,80,2,0
511,10593,815,34380,34670,290,2,0
512,10593,816,390,590,200,1,200
513,10605,5561,244170,244620,450,4,0
514,10605,5957,108530,109810,1280,3,0
515,10607,353,108100,108370,270,1,270
516,10607,353,112000,112850,850,2,830
517,10607,353,115200,115440,240,5,0
518,10607,353,115950,118210,2260,3,430
519,10607,356,107080,107320,240,1,0
520,10607,356,110130,110770,640,1,230
521,10607,356,111310,113060,1750,1,1640
522,10607,356,115020,117480,2460,2,1330
523,10607,356,119930,120150,220,1,220
524,10607,356,121250,122510,1260,3,1050
525,10607,356,127600,129250,1650,3,1650
526,10607,356,137230,138360,1130,4,450
527,10607,356,140800,141620,820,5,820
528,10607,356,142730,143400,670,2,0
529,10607,360,126890,129920,3030,4,2570
530,10607,362,125430,125710,280,2,0
531,10607,362,129460,131260,1800,3,1270
532,10607,362,133540,135730,2190,3,1900
533,10607,362,144190,144600,410,3,410
534,10607,362,145530,146230,700,3,220
535,10607,371,10490,10660,170,1,0
536,10607,371,12470,12810,340,1,340
537,10607,371,14170,14780,610,2,50
538,10607,371,15360,15580,220,2,0
539,10607,394,107170,108290,1120,4,1060
540,10607,402,101900,102510,610,4,370
541,10607,402,103260,107420,4160,5,2740
542,10607,402,111810,112450,640,2,640
543,10607,402,122310,123380,1070,3,1040
544,10607,402,126450,127540,1090,2,1010
545,10607,402,130010,131620,1610,4,1060
546,10607,402,132240,134670,2430,4,1700
547,10607,402,146850,147480,630,3,630
548,10607,402,151490,154480,2990,3,2400
549,10607,402,155180,156310,1130,6,70
550,10607,412,109200,110050,850,2,770
551,10607,412,111600,112240,640,2,640
552,10607,412,114650,116890,2240,2,2170
553,10607,412,118810,118960,150,2,150
554,10607,412,120370,121540,1170,2,1040
555,10607,412,122490,125280,2790,2,2590
556,10607,412,128520,129570,1050,2,990
557,10607,412,137260,146980,9720,3,7430
558,10607,412,151100,152910,1810,2,1530
559,10607,412,157030,158050,1020,5,350
560,10607,429,108570,108680,110,1,0
561,10607,432,117000,117660,660,3,660
562,10607,432,118670,119850,1180,4,830
563,10607,437,106820,106910,90,1,0
564,10607,437,108490,110210,1720,5,790
565,10607,437,110860,111700,840,4,0
566,10607,439,97190,97280,90,3,0
567,10607,439,102660,103220,560,1,560
568,10607,439,109540,109870,330,1,120
569,10607,439,124290,125450,1160,1,520
570,10607,439,125960,126050,90,1,90
571,10607,439,126960,127730,770,1,700
572,10607,439,136770,137370,600,5,0
573,10607,443,90190,90340,150,2,0
574,10607,443,91780,91900,120,1,0
575,10607,443,98440,98810,370,1,370
576,10607,443,102460,103150,690,1,690
577,10607,443,105580,105910,330,1,330
578,10607,443,113350,113990,640,2,370
579,10607,443,124760,135910,11150,1,11150
580,10607,443,138830,139580,750,1,70
581,10607,443,140260,140540,280,1,280
582,10607,443,142950,143140,190,1,0
583,10607,464,87480,87910,430,2,0
584,10607,464,91650,92560,910,1,620
585,10607,464,94420,95330,910,1,790
586,10607,471,100590,100960,370,1,0
587,10607,471,111490,112330,840,3,750
588,10607,471,112860,115200,2340,2,2060
589,10607,471,117010,117740,730,1,530
590,10607,471,119770,120960,1190,1,1190
591,10607,471,128290,129210,920,1,720
592,10607,471,131320,132210,890,1,890
593,10607,471,135720,136520,800,1,180
594,10607,471,139300,139380,80,3,0
595,10607,474,109530,110550,1020,2,880
596,10607,474,114950,118880,3930,3,3570
597,10607,474,130910,131600,690,1,420
598,10607,474,140120,140310,190,1,190
599,10607,474,148010,148830,820,1,500
600,10607,474,161330,162620,1290,1,1270
601,10607,474,166530,167640,1110,1,670
602,10607,479,97230,97460,230,2,0
603,10607,479,98070,98200,130,1,0
604,10607,479,100220,101980,1760,1,1570
605,10607,480,3680,5090,1410,1,1370
606,10607,501,103880,104540,660,4,0
607,10607,508,98520,98610,90,1,0
608,10607,508,101700,101930,230,1,230
609,10607,508,103240,109780,6540,3,5660
610,10607,508,110710,114990,4280,4,2730
611,10607,508,116680,116930,250,1,0
612,10607,675,97100,98250,1150,2,1030
613,10607,675,100230,102320,2090,3,1230
614,10607,675,107450,109220,1770,2,1680
615,10607,679,90480,91060,580,2,0
616,10607,679,93600,94000,400,1,210
617,10607,679,95020,95370,350,1,350
618,10607,679,97730,97840,110,1,110
619,10607,679,105170,105350,180,2,180
620,10607,679,107380,108430,1050,2,730
621,10607,679,109210,109620,410,1,410
622,10607,679,115040,115130,90,1,90
623,10607,679,115660,118580,2920,1,2120
624,10607,679,120120,121080,960,5,0
625,10607,684,108820,108980,160,1,0
626,10607,688,97670,97800,130,1,0
627,10607,688,103180,103600,420,5,0
628,10607,693,113460,113910,450,5,240
629,10607,710,128250,128590,340,1,0
630,10607,710,130770,133660,2890,2,2660
631,10607,710,141150,142580,1430,1,710
632,10607,710,147320,148240,920,1,670
633,10607,710,150440,150740,300,1,300
634,10607,710,153430,154050,620,1,0
635,10607,713,96700,96900,200,1,0
636,10607,713,102010,104950,2940,1,2940
637,10607,713,106940,107090,150,2,0
638,10607,713,108480,108740,260,2,60
639,10607,716,104990,105690,700,1,0
640,10607,716,106900,107470,570,2,0
641,10607,716,108180,108690,510,1,460
642,10607,716,112730,114450,1720,2,1700
643,10607,716,115540,116480,940,1,940
644,10607,721,96340,97430,1090,1,300
645,10607,723,106920,107020,100,2,0
646,10607,723,109370,110330,960,3,0
647,10607,723,111140,111590,450,1,450
648,10607,731,108170,109310,1140,1,230
649,10607,738,106950,107690,740,2,0
650,10607,738,113270,113490,220,1,220
651,10607,738,114140,138740,24600,3,23070
652,10607,738,139630,139800,170,1,170
653,10607,738,147230,148230,1000,2,790
654,10607,738,153350,153830,480,1,480
655,10607,738,160150,160890,740,3,550
656,10607,738,173530,174210,680,2,680
657,10607,738,186440,186640,200,1,200
658,10607,738,189490,189680,190,1,190
659,10607,738,195870,196450,580,1,530
660,10607,738,203890,211450,7560,3,6250
661,10607,738,214870,214970,100,1,0
662,10607,742,106080,112690,6610,3,6110
663,10607,745,111920,112100,180,1,0
664,10607,745,112680,113100,420,1,420
665,10607,745,117810,118030,220,2,0
666,10607,751,12760,13030,270,1,0
667,10607,751,18300,18510,210,1,0
668,10607,751,19650,19750,100,1,0
669,10607,751,29910,30350,440,2,0
670,10607,751,33410,40850,7440,2,0
671,10607,751,42000,42170,170,1,0
672,10607,768,114690,116840,2150,1,0
673,10607,772,122090,122240,150,1,0
674,10607,772,129000,129290,290,1,0
675,10607,772,131410,132610,1200,1,0
676,10607,772,136050,136400,350,1,0
677,10607,772,144630,145450,820,1,0
678,10607,772,151330,152560,1230,3,0
679,10607,786,104140,104280,140,1,0
680,10607,786,136860,139080,2220,1,0
681,10607,803,134250,134340,90,1,0
682,10607,803,172090,174540,2450,2,0
683,10607,805,108070,110530,2460,1,0
684,10607,805,120550,120640,90,1,0
685,10607,805,137980,138170,190,1,0
686,10607,805,143860,144020,160,1,0
687,10607,821,115750,116300,550,2,0
688,10607,821,117140,118850,1710,3,0
689,10607,824,121080,122040,960,1,0
690,10607,824,126370,126750,380,2,0
691,10607,826,134490,135100,610,1,0
692,10607,826,151880,151990,110,1,0
693,10607,826,158450,159180,730,1,0
694,10607,826,167080,168170,1090,1,0
695,10607,826,186150,186410,260,1,0
696,10607,826,189610,189660,50,2,0
697,10607,834,110890,111240,350,1,0
698,10607,834,111770,111960,190,1,0
699,10607,834,113810,114050,240,2,0
700,10607,834,127110,127760,650,1,0
701,10607,845,97540,98070,530,2,0
702,10607,845,102730,103690,960,1,0
703,10607,845,113490,113960,470,3,0
704,10607,850,107070,107860,790,1,0
705,10607,850,109150,110480,1330,2,0
706,10607,850,113040,113690,650,1,0
707,10607,854,104560,105060,500,2,0
708,10607,854,108420,108840,420,1,0
709,10607,858,151270,151380,110,1,0
710,10607,861,103420,103440,20,2,0
711,10607,861,105540,105990,450,2,0
712,10607,861,111580,112530,950,2,0
713,10607,861,120930,121080,150,1,0
714,10607,861,142010,142940,930,5,0
715,10607,877,143660,143940,280,2,0
716,10607,891,112040,112590,550,2,0
717,10607,894,109420,109670,250,1,0
718,10607,894,139640,139960,320,1,0
719,10607,894,140900,141090,190,1,0
720,10607,894,151660,151750,90,1,0
721,10607,894,170950,171130,180,1,0
722,10607,897,116420,116530,110,2,0
723,10607,897,123120,123300,180,6,0
724,10607,906,126940,127330,390,2,0
725,10607,906,132590,132710,120,1,0
726,10607,909,104490,104620,130,1,0
727,10607,909,106320,107210,890,1,0
728,10607,909,110120,110350,230,1,0
729,10607,909,113990,114660,670,1,0
730,10607,914,99670,99790,120,1,0
731,10607,916,103480,103970,490,1,0
732,10607,918,102630,103240,610,1,0
733,10607,919,570,1020,450,2,0
734,10607,936,96370,96460,90,1,0
735,10607,936,103360,104460,1100,1,0
736,10607,940,108910,109060,150,1,0
737,10607,940,109580,110000,420,1,0
738,10607,940,113390,113470,80,1,0
739,10607,940,114450,115230,780,1,0
740,10607,945,125660,125930,270,1,0
741,10607,945,126480,126890,410,2,0
742,10607,945,128440,128900,460,1,0
743,10607,945,135440,135570,130,1,0
744,10607,945,139890,140390,500,2,0
745,10607,1613,210,490,280,1,0
746,10607,5504,260400,262180,1780,2,0
747,10612,2481,2990,3740,750,1,0
748,10612,3536,4830,4930,100,1,0
749,10612,3536,5500,5740,240,1,0
750,10612,5766,57560,58050,490,3,0
751,10616,336,18250,19750,1500,3,0
752,10616,977,32460,35660,3200,4,780
753,10616,978,27680,27820,140,1,0
754,10616,978,67260,67760,500,2,0
755,10616,978,70440,70530,90,5,0
756,10616,1833,200570,200660,90,3,0
757,10616,1833,204550,204630,80,2,0
758,10618,55,102780,102880,100,1,0
759,10618,55,110760,110760,0,1,0
760,10618,56,101730,102080,350,1,0
761,10618,56,102610,103870,1260,2,0
762,10618,113,152710,153020,310,2,0
763,10618,126,11020,11170,150,1,0
764,10618,126,17670,18300,630,2,0
765,10618,134,5940,6030,90,3,0
766,10618,134,7300,7410,110,2,0
767,10618,138,163480,163580,100,1,0
768,10618,138,164390,165310,920,2,0
769,10618,158,120620,121520,900,1,0
770,10618,159,6770,7980,1210,2,0
771,10618,185,149520,150160,640,2,170
772,10618,185,155030,155170,140,1,0
773,10618,186,9270,9520,250,2,0
774,10618,213,8880,9760,880,1,0
775,10618,217,95370,96580,1210,2,0
776,10618,219,12140,13800,1660,2,0
777,10618,222,73080,73170,90,3,0
778,10618,222,85490,85510,20,2,0
779,10618,224,37850,38450,600,1,0
780,10618,224,39800,41130,1330,1,1130
781,10618,235,12080,12240,160,1,160
782,10618,235,63770,65380,1610,2,1390
783,10618,237,214560,214640,80,1,0
784,10618,238,9960,10950,990,2,0
785,10618,251,14430,15300,870,1,0
786,10618,251,16010,16950,940,3,620
787,10618,251,17550,19530,1980,3,1640
788,10618,251,25210,27010,1800,3,1290
789,10618,251,31130,31970,840,2,820
790,10618,253,15250,15400,150,1,0
791,10618,275,36240,36450,210,1,0
792,10618,276,15390,15640,250,2,0
793,10618,276,19440,19970,530,1,0
794,10618,277,6390,6590,200,1,0
795,10618,282,212900,213100,200,1,0
796,10618,283,26630,27830,1200,5,1140
797,10618,289,132530,133140,610,2,0
798,10618,289,137620,137990,370,1,0
799,10618,290,12040,12260,220,1,0
800,10618,301,141670,141680,10,1,0
801,10618,302,5390,5390,0,2,0
802,10618,308,7300,7950,650,3,0
803,10618,309,129730,130050,320,1,0
804,10618,324,150700,152730,2030,1,220
805,10618,337,122270,122650,380,3,0
806,10618,337,123240,123760,520,2,0
807,10618,338,12530,13050,520,2,0
808,10618,350,10090,10190,100,2,0
809,10618,350,13510,13660,150,1,0
810,10618,353,15100,15690,590,1,0
811,10618,353,16580,16710,130,2,0
812,10618,359,96130,96210,80,1,0
813,10618,360,7730,8020,290,3,0
814,10618,360,13620,13770,150,2,0
815,10618,373,6280,6380,100,2,0
816,10618,378,22340,22470,130,1,0
817,10618,378,29710,31710,2000,4,1890
818,10618,378,53190,53480,290,2,0
819,10618,379,8490,8600,110,1,0
820,10618,384,191620,191910,290,3,100
821,10618,387,102770,103060,290,2,0
822,10618,387,106830,107130,300,2,0
823,10618,389,5660,7120,1460,4,0
824,10618,393,7850,8000,150,3,0
825,10618,393,8850,9280,430,1,0
826,10618,395,5700,6030,330,3,0
827,10618,395,15020,15150,130,1,0
828,10618,402,33910,34830,920,3,70
829,10618,402,35920,37380,1460,1,1170
830,10618,402,52480,52860,380,1,0
831,10618,403,8900,8990,90,2,0
832,10618,425,80600,80770,170,1,0
833,10618,429,4100,4310,210,1,0
834,10618,439,36850,36990,140,1,0
835,10618,445,7180,7500,320,3,0
836,10618,445,12490,12740,250,1,0
837,10618,448,49140,49730,590,2,480
838,10618,448,72540,72770,230,2,0
839,10618,449,9440,11070,1630,2,0
840,10618,456,13610,14410,800,2,0
841,10618,458,93030,93060,30,1,0
842,10618,458,97500,97590,90,1,0
843,10618,458,107920,108620,700,1,0
844,10618,459,15710,15990,280,1,0
845,10618,462,12510,12640,130,1,0
846,10618,462,21650,21840,190,3,0
847,10618,466,10720,13340,2620,4,1460
848,10618,480,26160,26360,200,2,40
849,10618,480,27740,27830,90,1,0
850,10618,480,29640,31120,1480,3,320
851,10618,480,31800,32530,730,3,730
852,10618,480,35450,37470,2020,2,1960
853,10618,480,40510,41840,1330,2,1160
854,10618,480,42810,44670,1860,2,1640
855,10618,480,54220,57230,3010,2,2650
856,10618,480,59910,62000,2090,3,1840
857,10618,481,190630,190830,200,1,0
858,10618,481,221300,221580,280,2,240
859,10618,481,224600,226980,2380,3,2110
860,10618,481,230120,231060,940,3,900
861,10618,481,232640,235750,3110,3,2460
862,10618,481,243290,245260,1970,3,1710
863,10618,481,246220,248110,1890,3,1810
864,10618,482,13660,16070,2410,2,550
865,10618,487,185530,185560,30,2,0
866,10618,487,186240,186330,90,1,0
867,10618,492,111710,111900,190,1,0
868,10618,493,8030,8290,260,2,0
869,10618,493,15380,15730,350,3,0
870,10618,493,131950,132440,490,2,0
871,10618,493,141620,142900,1280,1,0
872,10618,497,116970,117580,610,3,0
873,10618,498,42400,43140,740,2,500
874,10618,498,46350,47080,730,2,650
875,10618,498,48260,49790,1530,2,1530
876,10618,498,51430,51760,330,2,330
877,10618,498,54090,54180,90,2,90
878,10618,499,316370,317620,1250,3,0
879,10618,509,11500,11650,150,1,0
880,10618,511,93870,96010,2140,3,1570
881,10618,511,115280,115390,110,4,0
882,10618,512,26850,27060,210,1,0
883,10618,515,13640,13840,200,1,0
884,10618,519,200980,201670,690,3,240
885,10618,522,106990,107180,190,1,0
886,10618,565,20660,20790,130,1,0
887,10618,566,343300,344240,940,3,0
888,10618,567,15240,15340,100,1,0
889,10618,571,10670,11040,370,2,0
890,10618,572,106810,107650,840,2,0
891,10618,580,17220,17340,120,4,0
892,10618,580,21060,23000,1940,2,1320
893,10618,580,31950,32410,460,2,240
894,10618,580,36060,38070,2010,2,1970
895,10618,580,40100,41440,1340,2,1060
896,10618,586,132560,132640,80,1,0
897,10618,595,168830,169740,910,1,730
898,10618,595,174400,177010,2610,2,1460
899,10618,597,119120,119660,540,1,0
900,10618,598,8830,9120,290,1,0
901,10618,598,10360,10520,160,2,0
902,10618,607,148200,148380,180,1,0
903,10618,607,149870,151430,1560,1,1430
904,10618,608,6940,7170,230,1,0
905,10618,614,6420,7600,1180,3,0
906,10618,630,176100,177260,1160,1,0
907,10618,630,178100,178200,100,1,0
908,10618,650,16410,17160,750,1,560
909,10618,650,17720,19160,1440,1,280
910,10618,660,9550,10050,500,3,150
911,10618,663,9420,11710,2290,3,0
912,10618,669,153380,153580,200,1,0
913,10618,673,29620,30520,900,2,0
914,10618,689,13890,14650,760,2,0
915,10618,699,10800,11350,550,2,0
916,10618,702,8890,9530,640,1,0
917,10618,702,13500,16170,2670,1,2390
918,10618,702,19560,20680,1120,2,1120
919,10618,702,27900,27920,20,3,0
920,10618,713,537060,537800,740,1,540
921,10618,713,543090,543940,850,2,0
922,10618,713,565730,565910,180,1,0
923,10618,714,33300,33530,230,1,0
924,10618,721,154060,154150,90,1,0
925,10618,728,194270,194310,40,1,0
926,10618,728,207380,207960,580,1,0
927,10618,728,210780,211110,330,1,330
928,10618,728,211670,212490,820,1,790
929,10618,728,215360,215800,440,1,440
930,10618,728,216940,218520,1580,1,1580
931,10618,728,220800,221610,810,2,670
932,10618,728,222150,223860,1710,3,1560
933,10618,728,224990,227860,2870,2,2420
934,10618,737,8810,9990,1180,2,0
935,10618,743,11580,11780,200,1,0
936,10618,743,32810,33120,310,1,310
937,10618,743,33690,34280,590,2,450
938,10618,754,6810,7280,470,2,0
939,10618,754,8670,13850,5180,3,2620
940,10618,754,35770,35910,140,1,0
941,10618,756,188520,188550,30,1,0
942,10618,756,194760,195080,320,1,0
943,10618,770,7560,7900,340,1,0
944,10618,776,11530,11990,460,2,0
945,10618,781,184510,185760,1250,4,1120
946,10618,781,190200,190310,110,5,110
947,10618,781,191530,192350,820,6,460
948,10618,788,108590,108690,100,1,0
949,10618,799,11420,11630,210,1,0
950,10618,801,167630,168860,1230,1,0
951,10618,816,115940,116070,130,1,0
952,10618,819,130960,131240,280,1,0
953,10618,840,193360,193970,610,1,0
954,10618,840,194750,194960,210,5,0
955,10618,840,196480,196880,400,1,0
956,10618,841,13890,14160,270,1,0
957,10618,841,15050,15720,670,1,440
958,10618,841,16920,17610,690,4,360
959,10618,848,131570,133500,1930,1,1700
960,10618,848,151840,152360,520,2,0
961,10618,849,8710,10680,1970,5,840
962,10618,849,11990,12280,290,1,0
963,10618,857,4360,4500,140,1,0
964,10618,875,215700,215730,30,1,0
965,10618,898,12900,13010,110,1,0
966,10618,907,12670,14200,1530,3,1450
967,10618,907,46420,46480,60,1,0
968,10618,907,65760,65980,220,2,0
969,10618,939,182580,183030,450,2,0
970,10618,939,183960,184060,100,2,0
971,10618,940,12960,13780,820,4,820
972,10618,940,20970,21470,500,2,0
973,10618,943,164400,165300,900,3,0
974,10618,943,165860,166290,430,1,0
975,10618,946,121880,122160,280,2,0
976,10618,947,8030,8580,550,2,0
977,10618,947,9540,9660,120,1,0
978,10618,948,125460,125510,50,1,0
979,10618,952,7890,9010,1120,2,0
980,10618,979,215580,215890,310,1,0
981,10618,999,11070,11530,460,2,0
982,10618,1025,154890,157490,2600,2,0
983,10618,1027,13370,15600,2230,4,0
984,10618,1033,7140,7460,320,3,0
985,10618,1036,109020,109650,630,1,0
986,10618,1042,93410,93950,540,2,0
987,10618,1043,9380,12840,3460,2,740
988,10618,1049,147240,147910,670,2,0
989,10618,1055,5250,5940,690,2,0
990,10618,1059,20150,21830,1680,3,760
991,10618,1059,24590,26230,1640,4,1240
992,10618,1059,48300,48400,100,4,0
993,10618,1068,6030,6560,530,1,0
994,10618,1079,73330,73510,180,1,0
995,10618,1089,4810,5230,420,2,0
996,10618,1093,20040,22990,2950,3,1830
997,10618,1098,6270,6900,630,2,0
998,10618,1099,273670,274010,340,1,0
999,10618,1100,13040,13380,340,3,0
1000,10618,1100,13960,14670,710,4,0
1001,10618,1118,17420,17620,200,1,0
1002,10618,1131,7100,7480,380,2,0
1003,10618,1148,7740,8610,870,2,0
1004,10618,1148,9290,9440,150,2,0
1005,10618,1152,153350,153410,60,1,0
1006,10618,1164,146850,146960,110,1,0
1007,10618,1164,148090,148250,160,1,0
1008,10618,1164,150120,151810,1690,3,1020
1009,10618,1164,152930,154500,1570,2,1450
1010,10618,1164,183400,183510,110,1,0
1011,10618,1164,184290,184390,100,1,0
1012,10618,1164,187700,188690,990,2,990
1013,10618,1164,193020,193180,160,2,0
1014,10618,1173,31680,31850,170,3,0
1015,10618,1176,6550,7300,750,2,0
1016,10618,1176,8970,9170,200,1,0
1017,10618,1176,15790,16040,250,3,250
1018,10618,1176,29580,35000,5420,4,4850
1019,10618,1176,43740,45080,1340,4,1100
1020,10618,1188,10270,10350,80,2,0
1021,10618,1188,12840,14150,1310,1,700
1022,10618,1188,25290,26700,1410,4,1170
1023,10618,1188,29510,32170,2660,3,2420
1024,10618,1188,34470,37550,3080,3,1590
1025,10618,1190,35230,35650,420,1,0
1026,10618,1190,39810,40010,200,1,0
1027,10618,1190,60590,61190,600,2,0
1028,10618,1194,3990,4600,610,4,0
1029,10618,1202,99280,99580,300,2,0
1030,10618,1230,158270,158930,660,2,0
1031,10618,1230,162240,163490,1250,2,1250
1032,10618,1230,167120,167860,740,2,670
1033,10618,1230,171210,172460,1250,3,1010
1034,10618,1230,182960,185960,3000,4,2000
1035,10618,1239,145000,145520,520,2,0
1036,10618,1257,5050,5450,400,2,0
1037,10618,1270,7920,8350,430,1,0
1038,10618,1274,9230,9690,460,1,0
1039,10618,1286,133360,133900,540,2,0
1040,10618,1289,8430,8910,480,2,0
1041,10618,1305,106430,107180,750,1,0
1042,10618,1305,107990,108080,90,1,0
1043,10618,1306,8650,10850,2200,2,1800
1044,10618,1306,27150,27980,830,2,830
1045,10618,1306,31390,34960,3570,3,3360
1046,10618,1306,37820,37860,40,2,0
1047,10618,1314,7890,7990,100,4,0
1048,10618,1319,121600,122010,410,1,0
1049,10618,1330,5160,5610,450,2,0
1050,10618,1335,17010,17110,100,1,0
1051,10618,1338,115690,116110,420,2,0
1052,10618,1349,6590,7300,710,2,0
1053,10618,1356,140130,140250,120,2,0
1054,10618,1357,122030,122300,270,1,0
1055,10618,1357,131780,134950,3170,4,2540
1056,10618,1357,135470,139260,3790,4,3530
1057,10618,1357,174670,174790,120,2,0
1058,10618,1357,181430,181750,320,2,0
1059,10618,1358,10250,10680,430,1,0
1060,10618,1358,12170,12490,320,1,0
1061,10618,1362,96980,97890,910,2,0
1062,10618,1363,16320,17700,1380,4,1270
1063,10618,1363,20840,20930,90,1,0
1064,10618,1374,148610,148800,190,3,0
1065,10618,1374,150720,151160,440,1,0
1066,10618,1374,151740,152710,970,2,500
1067,10618,1374,153250,153640,390,2,380
1068,10618,1374,155190,156570,1380,2,870
1069,10618,1374,158970,159770,800,3,800
1070,10618,1374,160450,163020,2570,3,1830
1071,10618,1374,165210,165770,560,2,0
1072,10618,1376,10390,13450,3060,3,2220
1073,10618,1376,15720,19240,3520,4,3190
1074,10618,1376,20900,23300,2400,4,2130
1075,10618,1376,25410,26060,650,2,650
1076,10618,1376,27160,28120,960,2,950
1077,10618,1376,29170,29710,540,3,0
1078,10618,1380,43800,43900,100,1,0
1079,10618,1380,45180,45560,380,1,0
1080,10618,1380,46440,48170,1730,1,1500
1081,10618,1380,49760,50680,920,1,920
1082,10618,1380,53730,55330,1600,3,1340
1083,10618,1380,84790,85220,430,1,0
1084,10618,1380,92080,92220,140,1,0
1085,10618,1381,5570,5690,120,2,0
1086,10618,1381,8740,10300,1560,4,860
1087,10618,1381,18910,19400,490,1,0
1088,10618,1381,68310,68390,80,1,0
1089,10618,1385,75810,76490,680,2,680
1090,10618,1385,84780,85410,630,3,160
1091,10618,1387,130330,130460,130,1,0
1092,10618,1387,132120,132250,130,1,0
1093,10618,1387,138900,140400,1500,2,1450
1094,10618,1388,7950,8640,690,4,0
1095,10618,1388,16880,17080,200,1,0
1096,10618,1395,5710,6130,420,2,0
1097,10618,1395,7200,7320,120,2,0
1098,10618,1433,40240,41010,770,2,0
1099,10618,1433,42720,43130,410,1,0
1100,10618,1433,43670,45980,2310,1,1630
1101,10618,1433,48630,49590,960,2,330
1102,10618,1433,50700,51560,860,2,730
1103,10618,1433,59170,59320,150,1,0
1104,10618,1435,186990,187630,640,2,0
1105,10618,1436,8930,9190,260,2,0
1106,10618,1470,172240,172350,110,1,0
1107,10618,1470,175620,175820,200,1,0
1108,10618,1471,9650,9780,130,1,0
1109,10618,1471,11000,11100,100,3,0
1110,10618,1471,32400,34410,2010,1,1940
1111,10618,1471,36980,37950,970,1,940
1112,10618,1471,44980,45080,100,1,100
1113,10618,1471,89390,90200,810,2,0
1114,10618,1471,93120,93290,170,2,0
1115,10618,1471,140870,141290,420,1,0
1116,10618,1483,178950,179650,700,2,0
1117,10618,1484,48170,48640,470,1,0
1118,10618,1484,49560,50250,690,4,0
1119,10618,1485,210300,210650,350,1,0
1120,10618,1486,29900,30640,740,1,590
1121,10618,1486,34770,35000,230,4,0
1122,10618,1488,161410,161560,150,1,0
1123,10618,1490,24010,24130,120,1,0
1124,10618,1496,9620,9710,90,3,0
1125,10618,1506,156180,156690,510,1,0
1126,10618,1507,8140,8680,540,3,0
1127,10618,1520,7740,8080,340,2,0
1128,10618,1532,8100,8510,410,3,0
1129,10618,1549,134880,135540,660,2,0
1130,10618,1553,208480,209240,760,2,0
1131,10618,1554,14310,16060,1750,1,1660
1132,10618,1554,16810,20020,3210,2,2200
1133,10618,1554,25030,26360,1330,2,960
1134,10618,1554,31600,33410,1810,1,1670
1135,10618,1554,36980,38090,1110,3,740
1136,10618,1563,151090,151680,590,2,0
1137,10618,1563,153150,153950,800,3,0
1138,10618,1563,155050,155150,100,2,100
1139,10618,1563,158800,158960,160,2,160
1140,10618,1566,13340,13520,180,1,0
1141,10618,1566,14800,15070,270,2,0
1142,10618,1566,16000,17070,1070,4,590
1143,10618,1566,19190,21180,1990,2,1540
1144,10618,1566,28640,30130,1490,3,1230
1145,10618,1566,35680,35830,150,4,0
1146,10618,1566,36580,37490,910,5,110
1147,10618,1566,50500,50760,260,1,0
1148,10618,1575,107180,107470,290,2,0
1149,10619,1441,159280,160100,820,1,0
1150,10619,1441,160730,162740,2010,3,0
1151,10619,1441,163520,163640,120,2,0
1152,13103,9590,123430,123820,390,1,0
1153,13103,9590,126660,126800,140,1,0
1154,13105,14812,243560,243930,370,2,0
1155,13105,14812,246470,246530,60,1,0
1156,13105,14812,247970,248040,70,3,0
1157,13106,18025,31170,32070,900,2,0
1158,13107,321,34380,34500,120,1,0
1159,13107,434,36400,37660,1260,1,0
1160,13107,3727,29960,30680,720,2,0
1161,13107,3778,32900,33280,380,2,0
1162,13107,3778,33880,34280,400,2,0
1163,13107,3836,5420,5920,500,2,0
1164,13107,3972,57410,58330,920,2,0
1165,13107,4135,36090,36470,380,1,0
1166,13107,4195,42790,43570,780,3,0
1167,13107,4351,33290,33870,580,1,0
1168,13107,4351,34740,34980,240,1,0
1169,13107,4459,10060,10550,490,1,0
1170,13107,4584,22590,23420,830,1,0
1171,13107,4652,5610,5950,340,2,0
1172,13107,4728,30240,30700,460,1,0
1173,13107,4838,65130,66840,1710,1,0
1174,13107,5214,39280,40350,1070,2,0
1175,13107,5261,47190,47520,330,1,0
1176,13107,5309,41670,42020,350,2,0
1177,13107,5310,5010,6300,1290,4,0
1178,13107,5395,39810,39830,20,3,0
1179,13107,5516,103580,104420,840,1,0
1180,13107,5590,111760,111830,70,1,0
1181,13107,5591,5890,6100,210,2,0
1182,13107,6037,25890,27360,1470,4,0
1183,13107,6263,44830,46740,1910,2,0
1184,13107,6377,12670,13480,810,3,0
1185,13107,6490,38510,40130,1620,1,0
1186,13107,6632,49160,49910,750,1,0
1187,13107,6710,45990,47220,1230,1,0
1188,13107,6968,11600,15940,4340,4,2350
1189,13107,7502,116080,116240,160,2,0
1190,13107,7953,5210,5620,410,7,0
1191,13107,8007,47790,48190,400,2,0
1192,13107,10155,4720,4980,260,1,0
1193,13107,10155,6270,6330,60,1,0
1194,13107,10511,67470,67820,350,1,0
1195,13107,11031,7230,7770,540,2,0
1196,13107,11292,5650,6380,730,2,0
1197,13107,11329,23540,23910,370,3,0
1198,13107,11329,24730,25090,360,2,0
1199,13107,11651,59830,60940,1110,3,0
1200,13107,12030,6660,8140,1480,2,0
1201,13107,12067,200040,200770,730,4,0
1202,13107,12175,30180,30680,500,2,0
1203,13107,12250,2150,2220,70,2,0
1204,13107,12416,91020,91120,100,1,0
1205,13107,16011,34520,34750,230,1,0
1206,13108,798,84710,85550,840,2,0
1207,13108,798,86200,86540,340,2,0
1208,13108,8094,5800,6380,580,2,0
1209,13108,8567,176230,177480,1250,3,0
1210,13109,12325,12710,13460,750,2,0
1211,13109,12439,16800,17790,990,3,0
1212,13109,12440,13110,13950,840,3,0
1213,13109,12807,14970,15280,310,2,0
1214,13109,12807,15970,16560,590,2,0
1215,13109,13044,15540,15670,130,1,0
1216,13109,14112,13630,14240,610,2,0
1217,13110,4709,65010,65670,660,2,0
1218,17101,609,93660,94230,570,1,0
1219,17101,1052,204110,204280,170,2,0
1220,17101,1167,109340,109910,570,1,0
1221,17101,1175,81170,81900,730,4,0
1222,17101,1182,90340,90520,180,2,0
1223,17101,1201,95280,95350,70,4,0
1224,17101,1213,78140,78630,490,3,0
1225,17101,1213,79350,79710,360,4,0
1226,17101,1213,245750,246080,330,2,0
1227,17101,1213,248130,248130,0,0,0
1228,17101,1220,82780,83680,900,3,0
1229,17101,1228,94150,94590,440,3,0
1230,17101,1236,94850,95340,490,2,0
1231,17101,1236,95870,95960,90,2,0
1232,17101,1236,255910,256020,110,3,0
1233,17101,2144,113000,113220,220,1,0
1234,17101,2144,433030,433130,100,3,0
1235,17101,2144,624450,624910,460,2,0
1236,17101,2144,627300,627460,160,1,0
1237,17101,2144,794010,794470,460,2,0
1238,17101,2144,797730,797840,110,2,0
1239,17101,2144,799410,799490,80,1,0
1240,17101,2144,972040,972710,670,1,130
1241,17101,2144,1257910,1258240,330,3,0
1242,17101,2144,1432840,1433130,290,2,0
1243,17101,2145,1611840,1611930,90,2,0
1244,17101,2145,1617130,1618510,1380,3,0
1245,17102,929,337940,338030,90,1,0
1246,17102,929,503370,504530,1160,2,0
1247,17102,929,507960,508260,300,2,0
1248,17102,929,508790,508800,10,1,0
1249,17102,929,692030,692310,280,1,0
1250,17102,1576,253080,253440,360,2,0
1251,17102,1576,256010,256060,50,1,0
1252,17102,1576,256870,257080,210,1,0
1253,17102,1576,589180,589510,330,2,0
1254,17102,1576,592460,592550,90,2,0
1255,17102,1607,260490,260730,240,2,0
1256,17102,1607,432020,432160,140,2,0
1257,17102,1669,173180,173520,340,1,0
1258,17102,1669,384380,384410,30,1,0
1259,17102,1669,717570,717840,270,3,0
1260,17102,1669,1111140,1111890,750,4,0
